time,option_contract_name,position,option_price,underlying_price,balance
2023-01-02 10:15:00, call4330020230105, sell, 285.95, 43302.45, 2285.95
2023-01-02 10:15:00, put4330020230105, sell, 308.65, 43302.45, 2594.6
2023-01-02 11:15:00, call4330020230105, buy, 302.85, 43369.25, 2291.75
2023-01-02 11:20:00, call4330020230105, sell, 306.35, 43306.85, 2598.1
2023-01-02 15:25:00, call4330020230105, buy, 256.3, 43223.05, 2341.7999999999997
2023-01-02 15:25:00, put4330020230105, buy, 291.4, 43223.05, 2050.3999999999996
2023-01-03 10:15:00, call4330020230105, sell, 324.0, 43399.3, 2374.3999999999996
2023-01-03 10:15:00, put4330020230105, sell, 187.05, 43399.3, 2561.45
2023-01-03 10:20:00, call4330020230105, buy, 316.1, 43433.7, 2245.35
2023-01-03 10:30:00, call4330020230105, sell, 307.05, 43398.5, 2552.4
2023-01-03 14:00:00, call4330020230105, buy, 310.35, 43447.2, 2242.05
2023-01-03 14:15:00, call4330020230105, sell, 273.05, 43412.7, 2515.1000000000004
2023-01-03 14:25:00, call4330020230105, buy, 330.7, 43444.4, 2184.4000000000005
2023-01-03 15:05:00, call4330020230105, sell, 294.75, 43411.7, 2479.1500000000005
2023-01-03 15:20:00, call4330020230105, buy, 310.5, 43440.3, 2168.6500000000005
2023-01-03 15:25:00, put4330020230105, buy, 140.0, 43435.1, 2028.6500000000005
2023-01-04 10:15:00, call4320020230105, sell, 231.15, 43279.8, 2259.8000000000006
2023-01-04 10:15:00, put4320020230105, sell, 192.5, 43279.8, 2452.3000000000006
2023-01-04 11:10:00, put4320020230105, buy, 230.55, 43137.0, 2221.7500000000005
2023-01-04 15:25:00, call4320020230105, buy, 107.1, 42933.6, 2114.6500000000005
2023-01-05 10:15:00, call4270020230112, sell, 528.0, 42756.6, 2642.6500000000005
2023-01-05 10:15:00, put4270020230112, sell, 291.9, 42756.6, 2934.5500000000006
2023-01-05 11:30:00, put4270020230112, buy, 364.0, 42697.95, 2570.5500000000006
2023-01-05 15:25:00, call4270020230112, buy, 311.05, 42628.65, 2259.5000000000005
2023-01-06 10:15:00, call4230020230112, sell, 377.3, 42326.7, 2636.8000000000006
2023-01-06 10:15:00, put4230020230112, sell, 328.2, 42326.7, 2965.0000000000005
2023-01-06 10:20:00, put4230020230112, buy, 311.9, 42298.2, 2653.1000000000004
2023-01-06 10:25:00, put4230020230112, sell, 313.2, 42344.65, 2966.3
2023-01-06 10:40:00, put4230020230112, buy, 332.55, 42267.8, 2633.75
2023-01-06 10:55:00, put4230020230112, sell, 289.3, 42329.55, 2923.05
2023-01-06 11:10:00, put4230020230112, buy, 302.4, 42296.65, 2620.65
2023-01-06 11:15:00, put4230020230112, sell, 305.6, 42333.45, 2926.25
2023-01-06 11:35:00, put4230020230112, buy, 307.65, 42269.1, 2618.6
2023-01-06 11:40:00, put4230020230112, sell, 300.5, 42309.45, 2919.1
2023-01-06 11:55:00, put4230020230112, buy, 300.85, 42291.0, 2618.25
2023-01-06 12:05:00, put4230020230112, sell, 290.45, 42324.3, 2908.7
2023-01-06 12:20:00, put4230020230112, buy, 319.0, 42297.6, 2589.7
2023-01-06 15:25:00, call4230020230112, buy, 284.05, 42182.55, 2305.6499999999996
2023-01-09 10:15:00, call4250020230112, sell, 318.75, 42520.65, 2624.3999999999996
2023-01-09 10:15:00, put4250020230112, sell, 257.15, 42520.65, 2881.5499999999997
2023-01-09 10:35:00, call4250020230112, buy, 324.55, 42568.7, 2556.9999999999995
2023-01-09 10:40:00, call4250020230112, sell, 329.05, 42516.15, 2886.0499999999997
2023-01-09 10:45:00, call4250020230112, buy, 325.1, 42545.75, 2560.95
2023-01-09 10:50:00, call4250020230112, sell, 339.55, 42523.05, 2900.5
2023-01-09 10:55:00, call4250020230112, buy, 337.35, 42559.2, 2563.15
2023-01-09 11:05:00, call4250020230112, sell, 323.35, 42528.1, 2886.5
2023-01-09 11:25:00, call4250020230112, buy, 332.35, 42549.7, 2554.15
2023-01-09 11:30:00, call4250020230112, sell, 356.85, 42536.6, 2911.0
2023-01-09 11:35:00, call4250020230112, buy, 384.25, 42612.4, 2526.75
2023-01-09 13:45:00, call4250020230112, sell, 261.4, 42515.6, 2788.15
2023-01-09 15:00:00, call4250020230112, buy, 312.55, 42558.35, 2475.6
2023-01-09 15:25:00, put4250020230112, buy, 194.95, 42591.05, 2280.65
2023-01-10 10:15:00, call4220020230112, sell, 288.45, 42203.9, 2569.1
2023-01-10 10:15:00, put4220020230112, sell, 221.7, 42203.9, 2790.7999999999997
2023-01-10 10:40:00, put4220020230112, buy, 277.45, 42104.45, 2513.35
2023-01-10 12:35:00, put4220020230112, sell, 250.6, 42150.55, 2763.95
2023-01-10 12:40:00, put4220020230112, buy, 297.95, 42144.4, 2466.0
2023-01-10 15:25:00, call4220020230112, buy, 192.95, 42037.65, 2273.05
2023-01-11 10:15:00, call4210020230112, sell, 337.65, 42179.65, 2610.7000000000003
2023-01-11 10:15:00, put4210020230112, sell, 142.35, 42179.65, 2753.05
2023-01-11 10:35:00, call4210020230112, buy, 328.8, 42265.2, 2424.25
2023-01-11 10:45:00, call4210020230112, sell, 293.45, 42201.15, 2717.7
2023-01-11 12:00:00, call4210020230112, buy, 308.5, 42253.05, 2409.2
2023-01-11 12:20:00, call4210020230112, sell, 299.05, 42225.85, 2708.25
2023-01-11 12:25:00, call4210020230112, buy, 309.85, 42254.2, 2398.4
2023-01-11 12:40:00, call4210020230112, sell, 266.15, 42215.6, 2664.55
2023-01-11 13:10:00, call4210020230112, buy, 287.0, 42235.3, 2377.55
2023-01-11 13:20:00, call4210020230112, sell, 290.35, 42223.9, 2667.9
2023-01-11 13:30:00, call4210020230112, buy, 283.6, 42239.75, 2384.3
2023-01-11 13:35:00, call4210020230112, sell, 274.2, 42230.3, 2658.5
2023-01-11 14:45:00, call4210020230112, buy, 272.85, 42239.65, 2385.65
2023-01-11 15:00:00, call4210020230112, sell, 335.55, 42229.4, 2721.2000000000003
2023-01-11 15:05:00, call4210020230112, buy, 255.15, 42287.1, 2466.05
2023-01-11 15:10:00, call4210020230112, sell, 275.65, 42214.4, 2741.7000000000003
2023-01-11 15:15:00, call4210020230112, buy, 274.1, 42234.65, 2467.6000000000004
2023-01-11 15:25:00, put4210020230112, buy, 105.35, 42218.75, 2362.2500000000005
2023-01-12 10:15:00, call4200020230119, sell, 523.15, 42088.1, 2885.4000000000005
2023-01-12 10:15:00, put4200020230119, sell, 322.25, 42088.1, 3207.6500000000005
2023-01-12 10:25:00, put4200020230119, buy, 369.7, 42052.05, 2837.9500000000007
2023-01-12 15:10:00, put4200020230119, sell, 291.6, 42095.45, 3129.5500000000006
2023-01-12 15:25:00, call4200020230119, buy, 440.85, 42087.25, 2688.7000000000007
2023-01-12 15:25:00, put4200020230119, buy, 326.0, 42087.25, 2362.7000000000007
2023-01-13 10:15:00, call4190020230119, sell, 420.25, 41922.75, 2782.9500000000007
2023-01-13 10:15:00, put4190020230119, sell, 320.7, 41922.75, 3103.6500000000005
2023-01-13 12:55:00, call4190020230119, buy, 554.15, 42205.4, 2549.5000000000005
2023-01-13 15:25:00, put4190020230119, buy, 147.2, 42385.9, 2402.3000000000006
2023-01-16 10:15:00, call4260020230119, sell, 276.45, 42602.2, 2678.7500000000005
2023-01-16 10:15:00, put4260020230119, sell, 295.5, 42602.2, 2974.2500000000005
2023-01-16 11:20:00, put4260020230119, buy, 389.8, 42435.05, 2584.4500000000003
2023-01-16 15:25:00, call4260020230119, buy, 134.55, 42206.4, 2449.9
2023-01-17 10:15:00, call4230020230119, sell, 297.2, 42318.7, 2747.1
2023-01-17 10:15:00, put4230020230119, sell, 225.2, 42318.7, 2972.2999999999997
2023-01-17 13:00:00, put4230020230119, buy, 409.65, 42009.65, 2562.6499999999996
2023-01-17 14:20:00, put4230020230119, sell, 351.75, 42055.55, 2914.3999999999996
2023-01-17 15:25:00, call4230020230119, buy, 219.35, 42289.6, 2695.0499999999997
2023-01-17 15:25:00, put4230020230119, buy, 213.15, 42289.6, 2481.8999999999996
2023-01-18 10:15:00, call4240020230119, sell, 232.55, 42488.95, 2714.45
2023-01-18 10:15:00, put4240020230119, sell, 180.55, 42488.95, 2895.0
2023-01-18 11:30:00, call4240020230119, buy, 240.75, 42509.3, 2654.25
2023-01-18 11:35:00, call4240020230119, sell, 242.4, 42475.75, 2896.65
2023-01-18 11:45:00, call4240020230119, buy, 265.5, 42537.5, 2631.15
2023-01-18 12:25:00, call4240020230119, sell, 246.7, 42473.15, 2877.85
2023-01-18 12:30:00, call4240020230119, buy, 251.55, 42493.1, 2626.2999999999997
2023-01-18 12:40:00, call4240020230119, sell, 210.25, 42477.35, 2836.5499999999997
2023-01-18 14:35:00, call4240020230119, buy, 235.2, 42495.35, 2601.35
2023-01-18 14:45:00, call4240020230119, sell, 226.85, 42483.45, 2828.2
2023-01-18 14:50:00, call4240020230119, buy, 213.3, 42498.2, 2614.8999999999996
2023-01-18 14:55:00, call4240020230119, sell, 215.6, 42476.15, 2830.4999999999995
2023-01-18 15:05:00, call4240020230119, buy, 203.85, 42496.0, 2626.6499999999996
2023-01-18 15:10:00, call4240020230119, sell, 191.7, 42482.2, 2818.3499999999995
2023-01-18 15:25:00, call4240020230119, buy, 201.05, 42450.45, 2617.2999999999993
2023-01-18 15:25:00, put4240020230119, buy, 136.5, 42450.45, 2480.7999999999993
2023-01-19 10:15:00, call4230020230125, sell, 409.05, 42362.2, 2889.8499999999995
2023-01-19 10:15:00, put4230020230125, sell, 318.05, 42362.2, 3207.8999999999996
2023-01-19 11:30:00, put4230020230125, buy, 323.35, 42289.85, 2884.5499999999997
2023-01-19 11:35:00, put4230020230125, sell, 330.95, 42329.05, 3215.4999999999995
2023-01-19 12:55:00, put4230020230125, buy, 317.7, 42282.85, 2897.7999999999997
2023-01-19 13:15:00, put4230020230125, sell, 318.4, 42313.2, 3216.2
2023-01-19 13:20:00, put4230020230125, buy, 309.65, 42280.95, 2906.5499999999997
2023-01-19 13:25:00, put4230020230125, sell, 311.35, 42312.8, 3217.8999999999996
2023-01-19 13:30:00, put4230020230125, buy, 305.45, 42293.35, 2912.45
2023-01-19 13:35:00, put4230020230125, sell, 301.0, 42329.85, 3213.45
2023-01-19 13:55:00, put4230020230125, buy, 301.7, 42297.7, 2911.75
2023-01-19 14:00:00, put4230020230125, sell, 300.9, 42307.8, 3212.65
2023-01-19 14:30:00, put4230020230125, buy, 319.1, 42252.6, 2893.55
2023-01-19 15:00:00, put4230020230125, sell, 294.45, 42301.65, 3188.0
2023-01-19 15:25:00, call4230020230125, buy, 334.1, 42310.05, 2853.9
2023-01-19 15:25:00, put4230020230125, buy, 293.5, 42310.05, 2560.4
2023-01-20 10:15:00, call4260020230125, sell, 323.7, 42650.2, 2884.1
2023-01-20 10:15:00, put4260020230125, sell, 269.35, 42650.2, 3153.45
2023-01-20 10:25:00, call4260020230125, buy, 327.1, 42682.0, 2826.35
2023-01-20 10:55:00, call4260020230125, sell, 324.8, 42655.65, 3151.15
2023-01-20 15:25:00, call4260020230125, buy, 238.0, 42495.45, 2913.15
2023-01-20 15:25:00, put4260020230125, buy, 300.15, 42495.45, 2613.0
2023-01-23 10:15:00, call4290020230125, sell, 241.85, 42927.1, 2854.85
2023-01-23 10:15:00, put4290020230125, sell, 206.1, 42927.1, 3060.95
2023-01-23 13:10:00, put4290020230125, buy, 269.5, 42753.05, 2791.45
2023-01-23 13:20:00, put4290020230125, sell, 236.25, 42791.45, 3027.7
2023-01-23 15:25:00, call4290020230125, buy, 174.75, 42827.55, 2852.95
2023-01-23 15:25:00, put4290020230125, buy, 226.95, 42827.55, 2626.0
2023-01-24 10:15:00, call4280020230125, sell, 225.55, 42892.35, 2851.55
2023-01-24 10:15:00, put4280020230125, sell, 120.8, 42892.35, 2972.3500000000004
2023-01-24 10:20:00, put4280020230125, buy, 116.4, 42885.85, 2855.9500000000003
2023-01-24 10:30:00, put4280020230125, sell, 117.6, 42909.4, 2973.55
2023-01-24 10:35:00, put4280020230125, buy, 119.95, 42883.35, 2853.6000000000004
2023-01-24 10:50:00, put4280020230125, sell, 109.65, 42894.2, 2963.2500000000005
2023-01-24 10:55:00, put4280020230125, buy, 121.8, 42883.6, 2841.4500000000003
2023-01-24 11:10:00, put4280020230125, sell, 114.05, 42897.4, 2955.5000000000005
2023-01-24 11:15:00, put4280020230125, buy, 127.85, 42861.0, 2827.6500000000005
2023-01-24 15:25:00, call4280020230125, buy, 119.7, 42722.7, 2707.9500000000007
2023-01-27 10:15:00, call4070020230202, sell, 641.55, 40758.7, 3349.500000000001
2023-01-27 10:15:00, put4070020230202, sell, 537.75, 40758.7, 3887.250000000001
2023-01-27 10:20:00, put4070020230202, buy, 548.9, 40679.8, 3338.350000000001
2023-01-27 10:30:00, put4070020230202, sell, 501.7, 40812.0, 3840.0500000000006
2023-01-27 10:35:00, put4070020230202, buy, 501.8, 40738.75, 3338.2500000000005
2023-01-27 10:40:00, put4070020230202, sell, 438.3, 40786.7, 3776.5500000000006
2023-01-27 10:55:00, put4070020230202, buy, 489.4, 40734.3, 3287.1500000000005
2023-01-27 15:25:00, call4070020230202, buy, 458.0, 40395.2, 2829.1500000000005
2023-01-30 10:15:00, call4030020230202, sell, 676.75, 40315.6, 3505.9000000000005
2023-01-30 10:15:00, put4030020230202, sell, 503.25, 40315.6, 4009.1500000000005
2023-01-30 13:50:00, put4030020230202, buy, 990.0, 39633.85, 3019.1500000000005
2023-01-30 14:10:00, put4030020230202, sell, 799.85, 39759.9, 3819.0000000000005
2023-01-30 15:25:00, call4030020230202, buy, 670.0, 40448.85, 3149.0000000000005
2023-01-30 15:25:00, put4030020230202, buy, 431.25, 40448.85, 2717.7500000000005
2023-01-31 10:15:00, call4020020230202, sell, 648.1, 40275.1, 3365.8500000000004
2023-01-31 10:15:00, put4020020230202, sell, 466.5, 40275.1, 3832.3500000000004
2023-01-31 12:00:00, call4020020230202, buy, 838.8, 40618.45, 2993.55
2023-01-31 12:15:00, call4020020230202, sell, 770.0, 40572.2, 3763.55
2023-01-31 12:35:00, call4020020230202, buy, 806.3, 40631.0, 2957.25
2023-01-31 13:00:00, call4020020230202, sell, 780.9, 40547.5, 3738.15
2023-01-31 13:10:00, call4020020230202, buy, 783.95, 40720.15, 2954.2
2023-01-31 14:20:00, call4020020230202, sell, 721.05, 40584.65, 3675.25
2023-01-31 15:00:00, call4020020230202, buy, 837.25, 40622.55, 2838.0
2023-01-31 15:10:00, call4020020230202, sell, 831.9, 40560.55, 3669.9
2023-01-31 15:15:00, call4020020230202, buy, 896.45, 40600.05, 2773.45
2023-01-31 15:25:00, put4020020230202, buy, 245.1, 40702.65, 2528.35
2023-02-01 10:15:00, call4100020230202, sell, 502.8, 41077.7, 3031.15
2023-02-01 10:15:00, put4100020230202, sell, 315.7, 41077.7, 3346.85
2023-02-01 10:30:00, call4100020230202, buy, 551.35, 41195.5, 2795.5
2023-02-01 11:25:00, call4100020230202, sell, 499.05, 41024.7, 3294.55
2023-02-01 11:35:00, call4100020230202, buy, 538.7, 41256.6, 2755.8500000000004
2023-02-01 14:00:00, call4100020230202, sell, 287.55, 41120.0, 3043.4000000000005
2023-02-01 14:15:00, call4100020230202, buy, 325.4, 41178.85, 2718.0000000000005
2023-02-01 14:20:00, call4100020230202, sell, 250.5, 40986.05, 2968.5000000000005
2023-02-01 14:25:00, put4100020230202, buy, 385.9, 40858.15, 2582.6000000000004
2023-02-01 15:25:00, call4100020230202, buy, 130.65, 40532.7, 2451.9500000000003
2023-02-02 10:15:00, call4030020230209, sell, 729.05, 40330.55, 3181.0
2023-02-02 10:15:00, put4030020230209, sell, 562.15, 40330.55, 3743.15
2023-02-02 14:50:00, call4030020230209, buy, 827.4, 40712.5, 2915.75
2023-02-02 14:55:00, call4030020230209, sell, 870.4, 40670.25, 3786.15
2023-02-02 15:00:00, call4030020230209, buy, 797.0, 40678.1, 2989.15
2023-02-02 15:05:00, call4030020230209, sell, 819.3, 40636.5, 3808.45
2023-02-02 15:15:00, call4030020230209, buy, 788.45, 40697.5, 3020.0
2023-02-02 15:20:00, call4030020230209, sell, 816.6, 40631.25, 3836.6
2023-02-02 15:25:00, call4030020230209, buy, 842.1, 40697.0, 2994.5
2023-02-02 15:25:00, put4030020230209, buy, 314.0, 40697.0, 2680.5
2023-02-03 10:15:00, call4110020230209, sell, 473.9, 41107.6, 3154.4
2023-02-03 10:15:00, put4110020230209, sell, 402.9, 41107.6, 3557.3
2023-02-03 10:40:00, put4110020230209, buy, 561.25, 40913.4, 2996.05
2023-02-03 10:55:00, put4110020230209, sell, 475.25, 40941.45, 3471.3
2023-02-03 11:05:00, put4110020230209, buy, 551.5, 40862.75, 2919.8
2023-02-03 12:55:00, put4110020230209, sell, 492.6, 40961.45, 3412.4
2023-02-03 13:05:00, put4110020230209, buy, 509.55, 40865.6, 2902.85
2023-02-03 13:20:00, put4110020230209, sell, 508.05, 40957.9, 3410.9
2023-02-03 13:30:00, put4110020230209, buy, 516.75, 40904.75, 2894.15
2023-02-03 13:40:00, put4110020230209, sell, 450.2, 40982.35, 3344.35
2023-02-03 14:35:00, call4110020230209, buy, 594.0, 41319.25, 2750.35
2023-02-03 15:25:00, put4110020230209, buy, 256.35, 41512.0, 2494.0
2023-02-06 10:15:00, call4160020230209, sell, 372.0, 41610.55, 2866.0
2023-02-06 10:15:00, put4160020230209, sell, 357.75, 41610.55, 3223.75
2023-02-06 10:40:00, put4160020230209, buy, 493.25, 41355.65, 2730.5
2023-02-06 11:10:00, put4160020230209, sell, 483.8, 41402.95, 3214.3
2023-02-06 11:15:00, put4160020230209, buy, 497.5, 41350.8, 2716.8
2023-02-06 11:25:00, put4160020230209, sell, 426.35, 41397.05, 3143.15
2023-02-06 11:40:00, put4160020230209, buy, 491.0, 41361.45, 2652.15
2023-02-06 11:55:00, put4160020230209, sell, 452.25, 41387.65, 3104.4
2023-02-06 12:20:00, put4160020230209, buy, 456.0, 41365.85, 2648.4
2023-02-06 12:25:00, put4160020230209, sell, 461.25, 41398.65, 3109.65
2023-02-06 12:30:00, put4160020230209, buy, 479.8, 41363.65, 2629.85
2023-02-06 12:45:00, put4160020230209, sell, 466.2, 41406.35, 3096.0499999999997
2023-02-06 12:50:00, put4160020230209, buy, 458.7, 41380.1, 2637.35
2023-02-06 13:00:00, put4160020230209, sell, 441.4, 41389.1, 3078.75
2023-02-06 13:15:00, put4160020230209, buy, 482.55, 41385.15, 2596.2
2023-02-06 13:30:00, put4160020230209, sell, 445.25, 41398.7, 3041.45
2023-02-06 14:40:00, put4160020230209, buy, 468.05, 41385.35, 2573.3999999999996
2023-02-06 14:55:00, put4160020230209, sell, 470.9, 41430.45, 3044.2999999999997
2023-02-06 15:00:00, put4160020230209, buy, 446.6, 41368.05, 2597.7
2023-02-06 15:05:00, put4160020230209, sell, 466.05, 41418.05, 3063.75
2023-02-06 15:10:00, put4160020230209, buy, 439.75, 41351.3, 2624.0
2023-02-06 15:25:00, call4160020230209, buy, 263.0, 41375.45, 2361.0
2023-02-07 10:15:00, call4140020230209, sell, 343.35, 41404.45, 2704.35
2023-02-07 10:15:00, put4140020230209, sell, 289.6, 41404.45, 2993.95
2023-02-07 11:35:00, put4140020230209, buy, 291.75, 41343.6, 2702.2
2023-02-07 11:40:00, put4140020230209, sell, 287.5, 41401.85, 2989.7
2023-02-07 12:20:00, put4140020230209, buy, 317.35, 41362.4, 2672.35
2023-02-07 13:45:00, put4140020230209, sell, 287.35, 41377.15, 2959.7
2023-02-07 13:50:00, put4140020230209, buy, 280.0, 41363.95, 2679.7
2023-02-07 13:55:00, put4140020230209, sell, 297.15, 41392.4, 2976.85
2023-02-07 14:00:00, put4140020230209, buy, 306.25, 41344.75, 2670.6
2023-02-07 14:10:00, put4140020230209, sell, 271.75, 41434.15, 2942.35
2023-02-07 14:55:00, call4140020230209, buy, 391.35, 41566.05, 2551.0
2023-02-07 15:10:00, call4140020230209, sell, 352.75, 41508.25, 2903.75
2023-02-07 15:25:00, call4140020230209, buy, 350.2, 41475.5, 2553.55
2023-02-07 15:25:00, put4140020230209, buy, 240.25, 41475.5, 2313.3
2023-02-08 10:15:00, call4150020230209, sell, 330.3, 41557.3, 2643.6000000000004
2023-02-08 10:15:00, put4150020230209, sell, 162.75, 41557.3, 2806.3500000000004
2023-02-08 10:50:00, put4150020230209, buy, 274.05, 41456.25, 2532.3
2023-02-08 11:00:00, put4150020230209, sell, 227.3, 41499.6, 2759.6000000000004
2023-02-08 12:30:00, put4150020230209, buy, 203.0, 41472.95, 2556.6000000000004
2023-02-08 12:35:00, put4150020230209, sell, 183.85, 41508.55, 2740.4500000000003
2023-02-08 15:25:00, call4150020230209, buy, 226.9, 41559.65, 2513.55
2023-02-08 15:25:00, put4150020230209, buy, 162.1, 41559.65, 2351.4500000000003
2023-02-09 10:15:00, call4140020230216, sell, 420.45, 41410.5, 2771.9
2023-02-09 10:15:00, put4140020230216, sell, 373.7, 41410.5, 3145.6
2023-02-09 15:25:00, call4140020230216, buy, 507.9, 41564.95, 2637.7
2023-02-09 15:25:00, put4140020230216, buy, 228.65, 41564.95, 2409.0499999999997
2023-02-10 10:15:00, call4160020230216, sell, 332.0, 41635.9, 2741.0499999999997
2023-02-10 10:15:00, put4160020230216, sell, 313.7, 41635.9, 3054.7499999999995
2023-02-10 15:25:00, call4160020230216, buy, 297.1, 41550.55, 2757.6499999999996
2023-02-10 15:25:00, put4160020230216, buy, 302.5, 41550.55, 2455.1499999999996
2023-02-13 10:15:00, call4130020230216, sell, 300.8, 41305.1, 2755.95
2023-02-13 10:15:00, put4130020230216, sell, 292.85, 41305.1, 3048.7999999999997
2023-02-13 12:25:00, put4130020230216, buy, 319.95, 41195.0, 2728.85
2023-02-13 13:05:00, put4130020230216, sell, 283.85, 41254.2, 3012.7
2023-02-13 15:25:00, call4130020230216, buy, 290.0, 41285.3, 2722.7
2023-02-13 15:25:00, put4130020230216, buy, 259.1, 41285.3, 2463.6
2023-02-14 10:15:00, call4120020230216, sell, 303.35, 41278.7, 2766.95
2023-02-14 10:15:00, put4120020230216, sell, 191.25, 41278.7, 2958.2
2023-02-14 12:50:00, call4120020230216, buy, 376.25, 41417.4, 2581.95
2023-02-14 13:00:00, call4120020230216, sell, 348.6, 41382.8, 2930.5499999999997
2023-02-14 13:05:00, call4120020230216, buy, 367.65, 41412.0, 2562.8999999999996
2023-02-14 15:25:00, put4120020230216, buy, 80.95, 41650.15, 2481.95
2023-02-15 10:15:00, call4150020230216, sell, 234.0, 41572.45, 2715.95
2023-02-15 10:15:00, put4150020230216, sell, 135.0, 41572.45, 2850.95
2023-02-15 11:30:00, call4150020230216, buy, 235.0, 41698.0, 2615.95
2023-02-15 11:35:00, call4150020230216, sell, 256.25, 41582.3, 2872.2
2023-02-15 15:10:00, call4150020230216, buy, 298.65, 41683.05, 2573.5499999999997
2023-02-15 15:25:00, put4150020230216, buy, 45.55, 41785.9, 2527.9999999999995
2023-02-16 10:15:00, call4180020230223, sell, 409.0, 41867.55, 2936.9999999999995
2023-02-16 10:15:00, put4180020230223, sell, 277.05, 41867.55, 3214.0499999999997
2023-02-16 10:30:00, put4180020230223, buy, 299.0, 41820.5, 2915.0499999999997
2023-02-16 10:45:00, put4180020230223, sell, 282.75, 41834.8, 3197.7999999999997
2023-02-16 11:45:00, put4180020230223, buy, 284.6, 41791.0, 2913.2
2023-02-16 11:50:00, put4180020230223, sell, 287.9, 41836.3, 3201.1
2023-02-16 11:55:00, put4180020230223, buy, 302.3, 41815.1, 2898.7999999999997
2023-02-16 12:05:00, put4180020230223, sell, 291.1, 41843.35, 3189.8999999999996
2023-02-16 12:10:00, put4180020230223, buy, 287.6, 41806.35, 2902.2999999999997
2023-02-16 13:30:00, put4180020230223, sell, 274.05, 41827.15, 3176.35
2023-02-16 13:45:00, put4180020230223, buy, 274.9, 41822.75, 2901.45
2023-02-16 13:50:00, put4180020230223, sell, 285.3, 41837.2, 3186.75
2023-02-16 13:55:00, put4180020230223, buy, 291.75, 41780.65, 2895.0
2023-02-16 15:25:00, call4180020230223, buy, 280.6, 41617.3, 2614.4
2023-02-17 10:15:00, call4140020230223, sell, 317.45, 41413.15, 2931.85
2023-02-17 10:15:00, put4140020230223, sell, 286.8, 41413.15, 3218.65
2023-02-17 10:20:00, put4140020230223, buy, 287.95, 41357.3, 2930.7000000000003
2023-02-17 10:30:00, put4140020230223, sell, 278.8, 41364.9, 3209.5000000000005
2023-02-17 10:40:00, put4140020230223, buy, 290.55, 41330.75, 2918.9500000000003
2023-02-17 10:55:00, put4140020230223, sell, 284.25, 41373.85, 3203.2000000000003
2023-02-17 11:05:00, put4140020230223, buy, 314.35, 41313.55, 2888.8500000000004
2023-02-17 15:25:00, call4140020230223, buy, 233.1, 41147.1, 2655.7500000000005
2023-02-20 10:15:00, call4120020230223, sell, 269.95, 41240.05, 2925.7000000000003
2023-02-20 10:15:00, put4120020230223, sell, 264.7, 41240.05, 3190.4
2023-02-20 11:15:00, put4120020230223, buy, 296.7, 41089.4, 2893.7000000000003
2023-02-20 11:20:00, put4120020230223, sell, 292.55, 41095.85, 3186.2500000000005
2023-02-20 11:30:00, put4120020230223, buy, 361.1, 41035.25, 2825.1500000000005
2023-02-20 15:25:00, call4120020230223, buy, 131.0, 40706.95, 2694.1500000000005
2023-02-21 10:15:00, call4070020230223, sell, 322.3, 40732.1, 3016.4500000000007
2023-02-21 10:15:00, put4070020230223, sell, 187.3, 40732.1, 3203.750000000001
2023-02-21 10:20:00, call4070020230223, buy, 346.45, 40799.15, 2857.300000000001
2023-02-21 12:10:00, call4070020230223, sell, 274.25, 40782.4, 3131.550000000001
2023-02-21 15:25:00, call4070020230223, buy, 220.95, 40670.35, 2910.6000000000013
2023-02-21 15:25:00, put4070020230223, buy, 195.85, 40670.35, 2714.7500000000014
2023-02-22 10:15:00, call4030020230223, sell, 232.05, 40378.1, 2946.8000000000015
2023-02-22 10:15:00, put4030020230223, sell, 150.1, 40378.1, 3096.9000000000015
2023-02-22 10:25:00, put4030020230223, buy, 164.3, 40333.55, 2932.6000000000013
2023-02-22 10:30:00, put4030020230223, sell, 160.3, 40345.85, 3092.9000000000015
2023-02-22 10:40:00, put4030020230223, buy, 178.25, 40333.8, 2914.6500000000015
2023-02-22 15:25:00, call4030020230223, buy, 60.75, 39981.15, 2853.9000000000015
2023-02-23 10:15:00, call4000020230302, sell, 475.0, 40031.7, 3328.9000000000015
2023-02-23 10:15:00, put4000020230302, sell, 344.7, 40031.7, 3673.6000000000013
2023-02-23 15:25:00, call4000020230302, buy, 433.1, 40025.0, 3240.5000000000014
2023-02-23 15:25:00, put4000020230302, buy, 281.45, 40025.0, 2959.0500000000015
2023-02-23 10:15:00, call4000020230302, sell, 475.0, 40031.7, 3434.0500000000015
2023-02-23 10:15:00, put4000020230302, sell, 344.7, 40031.7, 3778.7500000000014
2023-02-23 15:25:00, call4000020230302, buy, 433.1, 40025.0, 3345.6500000000015
2023-02-23 15:25:00, put4000020230302, buy, 281.45, 40025.0, 3064.2000000000016
2023-02-24 10:15:00, call4000020230302, sell, 412.0, 40074.6, 3476.2000000000016
2023-02-24 10:15:00, put4000020230302, sell, 260.75, 40074.6, 3736.9500000000016
2023-02-24 10:50:00, put4000020230302, buy, 307.7, 40018.3, 3429.250000000002
2023-02-24 11:20:00, put4000020230302, sell, 282.0, 40036.2, 3711.250000000002
2023-02-24 11:50:00, put4000020230302, buy, 306.5, 40016.0, 3404.750000000002
2023-02-24 12:00:00, put4000020230302, sell, 295.15, 40033.95, 3699.900000000002
2023-02-24 12:05:00, put4000020230302, buy, 277.35, 40019.3, 3422.550000000002
2023-02-24 12:10:00, put4000020230302, sell, 286.65, 40045.0, 3709.200000000002
2023-02-24 12:25:00, put4000020230302, buy, 318.55, 39984.5, 3390.650000000002
2023-02-24 14:05:00, put4000020230302, sell, 315.7, 40038.1, 3706.3500000000017
2023-02-24 14:10:00, put4000020230302, buy, 346.05, 39948.85, 3360.3000000000015
2023-02-24 15:25:00, call4000020230302, buy, 292.1, 39903.45, 3068.2000000000016
2023-02-27 10:15:00, call3980020230302, sell, 344.0, 39882.45, 3412.2000000000016
2023-02-27 10:15:00, put3980020230302, sell, 245.65, 39882.45, 3657.8500000000017
2023-02-27 11:20:00, call3980020230302, buy, 497.9, 40150.0, 3159.9500000000016
2023-02-27 11:25:00, call3980020230302, sell, 498.3, 40099.3, 3658.250000000002
2023-02-27 11:30:00, call3980020230302, buy, 496.9, 40140.35, 3161.3500000000017
2023-02-27 11:35:00, call3980020230302, sell, 495.6, 40109.65, 3656.9500000000016
2023-02-27 11:45:00, call3980020230302, buy, 571.95, 40220.45, 3085.000000000002
2023-02-27 12:25:00, call3980020230302, sell, 513.4, 40121.0, 3598.400000000002
2023-02-27 12:30:00, call3980020230302, buy, 525.0, 40136.2, 3073.400000000002
2023-02-27 13:20:00, call3980020230302, sell, 480.9, 40088.95, 3554.300000000002
2023-02-27 13:40:00, call3980020230302, buy, 535.9, 40140.2, 3018.400000000002
2023-02-27 15:25:00, put3980020230302, buy, 83.3, 40302.8, 2935.1000000000017
2023-02-28 10:15:00, call4020020230302, sell, 299.9, 40289.55, 3235.000000000002
2023-02-28 10:15:00, put4020020230302, sell, 190.95, 40289.55, 3425.9500000000016
2023-02-28 14:10:00, put4020020230302, buy, 277.7, 40159.95, 3148.250000000002
2023-02-28 14:35:00, put4020020230302, sell, 205.25, 40217.4, 3353.500000000002
2023-02-28 14:40:00, put4020020230302, buy, 205.0, 40187.0, 3148.500000000002
2023-02-28 15:00:00, put4020020230302, sell, 166.2, 40219.35, 3314.7000000000016
2023-02-28 15:25:00, call4020020230302, buy, 264.05, 40283.4, 3050.6500000000015
2023-02-28 15:25:00, put4020020230302, buy, 166.85, 40283.4, 2883.8000000000015
2023-03-01 10:15:00, call4050020230302, sell, 190.7, 40550.85, 3074.5000000000014
2023-03-01 10:15:00, put4050020230302, sell, 154.9, 40550.85, 3229.4000000000015
2023-03-01 10:35:00, call4050020230302, buy, 215.35, 40597.95, 3014.0500000000015
2023-03-01 10:40:00, call4050020230302, sell, 229.5, 40559.95, 3243.5500000000015
2023-03-01 10:45:00, call4050020230302, buy, 227.75, 40611.05, 3015.8000000000015
2023-03-01 12:25:00, call4050020230302, sell, 218.2, 40526.2, 3234.0000000000014
2023-03-01 12:30:00, call4050020230302, buy, 219.85, 40590.55, 3014.1500000000015
2023-03-01 13:25:00, call4050020230302, sell, 203.15, 40529.55, 3217.3000000000015
2023-03-01 13:30:00, call4050020230302, buy, 209.1, 40582.75, 3008.2000000000016
2023-03-01 15:25:00, put4050020230302, buy, 62.0, 40689.6, 2946.2000000000016
2023-03-02 10:15:00, call4060020230309, sell, 354.25, 40619.7, 3300.4500000000016
2023-03-02 10:15:00, put4060020230309, sell, 271.5, 40619.7, 3571.9500000000016
2023-03-02 13:15:00, put4060020230309, buy, 299.8, 40540.25, 3272.1500000000015
2023-03-02 15:25:00, call4060020230309, buy, 208.6, 40393.65, 3063.5500000000015
2023-03-03 10:15:00, call4090020230309, sell, 338.55, 40959.85, 3402.1000000000017
2023-03-03 10:15:00, put4090020230309, sell, 221.15, 40959.85, 3623.250000000002
2023-03-03 10:20:00, call4090020230309, buy, 384.45, 41008.35, 3238.800000000002
2023-03-03 15:25:00, put4090020230309, buy, 133.35, 41225.85, 3105.450000000002
2023-03-06 10:15:00, call4160020230309, sell, 232.25, 41648.15, 3337.700000000002
2023-03-06 10:15:00, put4160020230309, sell, 189.65, 41648.15, 3527.350000000002
2023-03-06 11:30:00, put4160020230309, buy, 339.15, 41364.8, 3188.200000000002
2023-03-06 11:40:00, put4160020230309, sell, 310.75, 41414.4, 3498.950000000002
2023-03-06 12:15:00, put4160020230309, buy, 323.0, 41383.85, 3175.950000000002
2023-03-06 12:20:00, put4160020230309, sell, 319.35, 41427.7, 3495.300000000002
2023-03-06 12:25:00, put4160020230309, buy, 306.25, 41400.55, 3189.050000000002
2023-03-06 12:30:00, put4160020230309, sell, 325.15, 41451.95, 3514.200000000002
2023-03-06 12:35:00, put4160020230309, buy, 332.7, 41392.2, 3181.5000000000023
2023-03-06 13:05:00, put4160020230309, sell, 323.05, 41421.6, 3504.5500000000025
2023-03-06 13:10:00, put4160020230309, buy, 310.0, 41390.5, 3194.5500000000025
2023-03-06 13:15:00, put4160020230309, sell, 299.3, 41441.55, 3493.8500000000026
2023-03-06 13:25:00, put4160020230309, buy, 322.7, 41388.15, 3171.150000000003
2023-03-06 15:25:00, call4160020230309, buy, 111.65, 41375.35, 3059.5000000000027
2023-03-08 10:15:00, call4120020230309, sell, 198.85, 41245.15, 3258.3500000000026
2023-03-08 10:15:00, put4120020230309, sell, 155.5, 41245.15, 3413.8500000000026
2023-03-08 14:05:00, call4120020230309, buy, 318.6, 41423.3, 3095.2500000000027
2023-03-08 15:25:00, put4120020230309, buy, 34.75, 41605.75, 3060.5000000000027
2023-03-09 10:15:00, call4140020230316, sell, 360.0, 41490.2, 3420.5000000000027
2023-03-09 10:15:00, put4140020230316, sell, 288.8, 41490.2, 3709.300000000003
2023-03-09 11:45:00, call4140020230316, buy, 456.25, 41634.1, 3253.050000000003
2023-03-09 11:55:00, call4140020230316, sell, 413.7, 41609.9, 3666.7500000000027
2023-03-09 12:40:00, put4140020230316, buy, 287.1, 41428.05, 3379.650000000003
2023-03-09 12:45:00, put4140020230316, sell, 285.65, 41450.85, 3665.300000000003
2023-03-09 13:50:00, put4140020230316, buy, 320.6, 41375.65, 3344.700000000003
2023-03-09 15:25:00, call4140020230316, buy, 274.0, 41221.6, 3070.700000000003
2023-03-10 10:15:00, call4050020230316, sell, 346.15, 40545.7, 3416.850000000003
2023-03-10 10:15:00, put4050020230316, sell, 291.0, 40545.7, 3707.850000000003
2023-03-10 15:00:00, put4050020230316, buy, 316.85, 40356.7, 3391.000000000003
2023-03-10 15:05:00, put4050020230316, sell, 279.75, 40451.85, 3670.750000000003
2023-03-10 15:25:00, call4050020230316, buy, 318.45, 40488.1, 3352.3000000000034
2023-03-10 15:25:00, put4050020230316, buy, 273.65, 40488.1, 3078.6500000000033
2023-03-13 10:15:00, call4050020230316, sell, 274.35, 40517.0, 3353.000000000003
2023-03-13 10:15:00, put4050020230316, sell, 244.35, 40517.0, 3597.350000000003
2023-03-13 11:35:00, put4050020230316, buy, 416.0, 40332.85, 3181.350000000003
2023-03-13 15:25:00, call4050020230316, buy, 78.0, 39558.8, 3103.350000000003
2023-03-14 10:15:00, call3950020230316, sell, 315.9, 39524.1, 3419.250000000003
2023-03-14 10:15:00, put3950020230316, sell, 273.55, 39524.1, 3692.8000000000034
2023-03-14 10:30:00, put3950020230316, buy, 386.1, 39307.4, 3306.7000000000035
2023-03-14 10:50:00, put3950020230316, sell, 379.7, 39350.05, 3686.4000000000033
2023-03-14 10:55:00, put3950020230316, buy, 399.0, 39313.6, 3287.4000000000033
2023-03-14 12:30:00, put3950020230316, sell, 232.55, 39405.8, 3519.9500000000035
2023-03-14 13:05:00, put3950020230316, buy, 364.45, 39310.2, 3155.5000000000036
2023-03-14 13:35:00, put3950020230316, sell, 287.5, 39504.6, 3443.0000000000036
2023-03-14 14:00:00, put3950020230316, buy, 299.8, 39318.9, 3143.2000000000035
2023-03-14 14:05:00, put3950020230316, sell, 319.25, 39367.05, 3462.4500000000035
2023-03-14 15:25:00, call3950020230316, buy, 281.55, 39369.65, 3180.9000000000033
2023-03-14 15:25:00, put3950020230316, buy, 290.5, 39369.65, 2890.4000000000033
2023-03-15 10:15:00, call3960020230316, sell, 267.6, 39641.2, 3158.000000000003
2023-03-15 10:15:00, put3960020230316, sell, 155.3, 39641.2, 3313.3000000000034
2023-03-15 10:40:00, put3960020230316, buy, 187.85, 39582.85, 3125.4500000000035
2023-03-15 11:30:00, put3960020230316, sell, 156.45, 39687.5, 3281.9000000000033
2023-03-15 11:40:00, put3960020230316, buy, 159.15, 39627.05, 3122.750000000003
2023-03-15 11:45:00, put3960020230316, sell, 162.7, 39642.0, 3285.450000000003
2023-03-15 12:00:00, put3960020230316, buy, 179.8, 39622.9, 3105.650000000003
2023-03-15 15:25:00, call3960020230316, buy, 29.15, 38990.9, 3076.5000000000027
2023-03-16 10:15:00, call3860020230323, sell, 596.0, 38635.95, 3672.5000000000027
2023-03-16 10:15:00, put3860020230323, sell, 431.55, 38635.95, 4104.050000000003
2023-03-16 11:00:00, call3860020230323, buy, 872.0, 39149.95, 3232.050000000003
2023-03-16 11:25:00, call3860020230323, sell, 893.95, 39061.25, 4126.000000000003
2023-03-16 11:30:00, call3860020230323, buy, 865.8, 39160.05, 3260.2000000000025
2023-03-16 11:40:00, call3860020230323, sell, 809.7, 39059.85, 4069.9000000000024
2023-03-16 14:15:00, call3860020230323, buy, 911.5, 39110.25, 3158.4000000000024
2023-03-16 15:00:00, call3860020230323, sell, 849.65, 39060.2, 4008.0500000000025
2023-03-16 15:05:00, call3860020230323, buy, 881.6, 39099.15, 3126.4500000000025
2023-03-16 15:15:00, call3860020230323, sell, 865.7, 39060.95, 3992.1500000000024
2023-03-16 15:20:00, call3860020230323, buy, 957.0, 39105.9, 3035.1500000000024
2023-03-16 15:25:00, put3860020230323, buy, 210.45, 39196.05, 2824.7000000000025
2023-03-17 10:15:00, call3920020230323, sell, 486.9, 39255.5, 3311.6000000000026
2023-03-17 10:15:00, put3920020230323, sell, 351.8, 39255.5, 3663.400000000003
2023-03-17 10:30:00, put3920020230323, buy, 379.0, 39190.0, 3284.400000000003
2023-03-17 10:40:00, put3920020230323, sell, 368.4, 39265.0, 3652.800000000003
2023-03-17 10:55:00, put3920020230323, buy, 377.25, 39189.45, 3275.550000000003
2023-03-17 14:05:00, put3920020230323, sell, 355.75, 39238.4, 3631.300000000003
2023-03-17 14:15:00, put3920020230323, buy, 365.45, 39206.85, 3265.850000000003
2023-03-17 14:40:00, put3920020230323, sell, 311.1, 39301.2, 3576.950000000003
2023-03-17 15:15:00, call3920020230323, buy, 666.25, 39656.25, 2910.700000000003
2023-03-17 15:25:00, put3920020230323, buy, 175.35, 39627.2, 2735.350000000003
2023-03-20 10:15:00, call3910020230323, sell, 430.2, 39136.55, 3165.550000000003
2023-03-20 10:15:00, put3910020230323, sell, 318.85, 39136.55, 3484.400000000003
2023-03-20 10:30:00, put3910020230323, buy, 357.05, 39085.55, 3127.3500000000026
2023-03-20 10:45:00, put3910020230323, sell, 326.15, 39142.55, 3453.5000000000027
2023-03-20 12:15:00, put3910020230323, buy, 376.35, 39085.1, 3077.150000000003
2023-03-20 12:50:00, put3910020230323, sell, 377.55, 39142.3, 3454.700000000003
2023-03-20 12:55:00, put3910020230323, buy, 411.0, 39068.95, 3043.700000000003
2023-03-20 14:25:00, put3910020230323, sell, 328.75, 39121.2, 3372.450000000003
2023-03-20 15:25:00, call3910020230323, buy, 527.5, 39407.75, 2844.950000000003
2023-03-20 15:25:00, put3910020230323, buy, 213.2, 39407.75, 2631.750000000003
2023-03-21 10:15:00, call3950020230323, sell, 370.5, 39538.7, 3002.250000000003
2023-03-21 10:15:00, put3950020230323, sell, 272.55, 39538.7, 3274.8000000000034
2023-03-21 12:55:00, call3950020230323, buy, 410.35, 39646.65, 2864.4500000000035
2023-03-21 15:25:00, put3950020230323, buy, 118.7, 39853.35, 2745.7500000000036
2023-03-22 10:15:00, call3990020230323, sell, 261.25, 39975.6, 3007.0000000000036
2023-03-22 10:15:00, put3990020230323, sell, 216.0, 39975.6, 3223.0000000000036
2023-03-22 15:25:00, call3990020230323, buy, 275.0, 40013.3, 2948.0000000000036
2023-03-22 15:25:00, put3990020230323, buy, 175.85, 40013.3, 2772.1500000000037
2023-03-23 10:15:00, call3990020230329, sell, 511.0, 39969.4, 3283.1500000000037
2023-03-23 10:15:00, put3990020230329, sell, 288.15, 39969.4, 3571.300000000004
2023-03-23 10:35:00, call3990020230329, buy, 572.0, 40091.6, 2999.300000000004
2023-03-23 10:45:00, call3990020230329, sell, 536.5, 40054.2, 3535.800000000004
2023-03-23 12:25:00, call3990020230329, buy, 535.5, 40076.6, 3000.300000000004
2023-03-23 13:55:00, call3990020230329, sell, 493.4, 40030.9, 3493.700000000004
2023-03-23 15:10:00, put3990020230329, buy, 471.1, 39678.3, 3022.600000000004
2023-03-23 15:25:00, call3990020230329, buy, 253.5, 39582.0, 2769.100000000004
2023-03-24 10:15:00, call3940020230329, sell, 488.3, 39476.5, 3257.400000000004
2023-03-24 10:15:00, put3940020230329, sell, 273.45, 39476.5, 3530.850000000004
2023-03-24 11:45:00, call3940020230329, buy, 594.0, 39706.3, 2936.850000000004
2023-03-24 12:45:00, call3940020230329, sell, 507.55, 39599.55, 3444.400000000004
2023-03-24 13:15:00, call3940020230329, buy, 557.0, 39682.0, 2887.400000000004
2023-03-24 13:25:00, call3940020230329, sell, 539.2, 39662.2, 3426.600000000004
2023-03-24 13:30:00, call3940020230329, buy, 529.6, 39668.55, 2897.000000000004
2023-03-24 13:40:00, call3940020230329, sell, 472.9, 39602.35, 3369.900000000004
2023-03-24 15:10:00, put3940020230329, buy, 300.6, 39423.3, 3069.3000000000043
2023-03-24 15:15:00, put3940020230329, sell, 306.05, 39462.1, 3375.3500000000045
2023-03-24 15:25:00, call3940020230329, buy, 325.15, 39365.85, 3050.2000000000044
2023-03-24 15:25:00, put3940020230329, buy, 363.65, 39365.85, 2686.5500000000043
2023-03-27 10:15:00, call3950020230329, sell, 341.6, 39529.2, 3028.150000000004
2023-03-27 10:15:00, put3950020230329, sell, 269.55, 39529.2, 3297.7000000000044
2023-03-27 11:25:00, put3950020230329, buy, 352.5, 39312.15, 2945.2000000000044
2023-03-27 11:30:00, put3950020230329, sell, 357.55, 39356.55, 3302.7500000000045
2023-03-27 14:30:00, call3950020230329, buy, 389.1, 39603.3, 2913.6500000000046
2023-03-27 14:55:00, call3950020230329, sell, 376.2, 39569.4, 3289.8500000000045
2023-03-27 15:00:00, call3950020230329, buy, 356.25, 39654.5, 2933.6000000000045
2023-03-27 15:05:00, call3950020230329, sell, 298.85, 39548.55, 3232.4500000000044
2023-03-27 15:25:00, call3950020230329, buy, 227.35, 39306.05, 3005.1000000000045
2023-03-27 15:25:00, put3950020230329, buy, 267.75, 39306.05, 2737.3500000000045
2023-03-28 10:15:00, call3940020230329, sell, 279.2, 39420.7, 3016.5500000000043
2023-03-28 10:15:00, put3940020230329, sell, 156.2, 39420.7, 3172.750000000004
2023-03-28 10:40:00, put3940020230329, buy, 199.95, 39354.4, 2972.8000000000043
2023-03-28 11:15:00, put3940020230329, sell, 170.1, 39411.75, 3142.900000000004
2023-03-28 14:20:00, put3940020230329, buy, 189.8, 39389.6, 2953.100000000004
2023-03-28 14:30:00, put3940020230329, sell, 145.0, 39440.3, 3098.100000000004
2023-03-28 15:05:00, call3940020230329, buy, 248.9, 39569.35, 2849.200000000004
2023-03-28 15:20:00, call3940020230329, sell, 270.95, 39544.75, 3120.1500000000037
2023-03-28 15:25:00, call3940020230329, buy, 301.65, 39576.75, 2818.5000000000036
2023-03-28 15:25:00, put3940020230329, buy, 81.0, 39576.75, 2737.5000000000036
2023-03-31 10:15:00, call4040020230406, sell, 368.45, 40483.65, 3105.9500000000035
2023-03-31 10:15:00, put4040020230406, sell, 287.45, 40483.65, 3393.4000000000033
2023-03-31 12:50:00, call4040020230406, buy, 396.65, 40541.45, 2996.750000000003
2023-03-31 13:00:00, call4040020230406, sell, 382.4, 40512.6, 3379.1500000000033
2023-03-31 13:10:00, call4040020230406, buy, 393.8, 40541.0, 2985.350000000003
2023-03-31 13:20:00, call4040020230406, sell, 393.55, 40486.5, 3378.9000000000033
2023-03-31 13:25:00, call4040020230406, buy, 397.85, 40538.5, 2981.0500000000034
2023-03-31 13:40:00, call4040020230406, sell, 384.2, 40518.1, 3365.250000000003
2023-03-31 13:50:00, call4040020230406, buy, 406.05, 40562.9, 2959.200000000003
2023-03-31 15:25:00, put4040020230406, buy, 221.0, 40545.7, 2738.200000000003
2023-04-03 10:15:00, call4060020230406, sell, 297.05, 40676.2, 3035.250000000003
2023-04-03 10:15:00, put4060020230406, sell, 232.45, 40676.2, 3267.700000000003
2023-04-03 12:15:00, call4060020230406, buy, 310.55, 40739.9, 2957.150000000003
2023-04-03 12:20:00, call4060020230406, sell, 324.55, 40674.85, 3281.700000000003
2023-04-03 12:25:00, call4060020230406, buy, 317.0, 40730.75, 2964.700000000003
2023-04-03 12:30:00, call4060020230406, sell, 320.0, 40691.6, 3284.700000000003
2023-04-03 12:35:00, call4060020230406, buy, 322.55, 40726.7, 2962.150000000003
2023-04-03 12:45:00, call4060020230406, sell, 321.25, 40686.5, 3283.400000000003
2023-04-03 12:50:00, call4060020230406, buy, 327.95, 40711.95, 2955.450000000003
2023-04-03 13:05:00, call4060020230406, sell, 301.5, 40676.45, 3256.950000000003
2023-04-03 13:10:00, call4060020230406, buy, 307.6, 40725.6, 2949.350000000003
2023-04-03 13:20:00, call4060020230406, sell, 311.4, 40698.45, 3260.750000000003
2023-04-03 13:25:00, call4060020230406, buy, 309.2, 40714.8, 2951.5500000000034
2023-04-03 13:35:00, call4060020230406, sell, 314.9, 40690.35, 3266.4500000000035
2023-04-03 13:40:00, call4060020230406, buy, 310.45, 40744.0, 2956.0000000000036
2023-04-03 14:05:00, call4060020230406, sell, 336.25, 40699.6, 3292.2500000000036
2023-04-03 14:10:00, call4060020230406, buy, 338.0, 40795.35, 2954.2500000000036
2023-04-03 15:25:00, put4060020230406, buy, 126.45, 40810.6, 2827.800000000004
2023-04-05 10:15:00, call4080020230406, sell, 226.3, 40891.65, 3054.100000000004
2023-04-05 10:15:00, put4080020230406, sell, 142.5, 40891.65, 3196.600000000004
2023-04-05 12:55:00, call4080020230406, buy, 240.0, 40978.3, 2956.600000000004
2023-04-05 13:00:00, call4080020230406, sell, 252.45, 40954.5, 3209.050000000004
2023-04-05 13:05:00, call4080020230406, buy, 317.55, 40982.7, 2891.5000000000036
2023-04-05 13:40:00, call4080020230406, sell, 258.95, 40960.2, 3150.4500000000035
2023-04-05 14:40:00, call4080020230406, buy, 256.85, 40984.95, 2893.6000000000035
2023-04-05 14:45:00, call4080020230406, sell, 257.65, 40952.0, 3151.2500000000036
2023-04-05 14:50:00, call4080020230406, buy, 267.75, 40983.3, 2883.5000000000036
2023-04-05 15:20:00, call4080020230406, sell, 275.65, 40967.7, 3159.1500000000037
2023-04-05 15:25:00, call4080020230406, buy, 272.9, 41014.0, 2886.2500000000036
2023-04-05 15:25:00, put4080020230406, buy, 75.35, 41014.0, 2810.9000000000037
2023-04-06 10:15:00, call4110020230413, sell, 342.8, 41118.5, 3153.700000000004
2023-04-06 10:15:00, put4110020230413, sell, 274.65, 41118.5, 3428.350000000004
2023-04-06 10:55:00, call4110020230413, buy, 376.15, 41178.1, 3052.200000000004
2023-04-06 11:50:00, call4110020230413, sell, 336.75, 41162.05, 3388.950000000004
2023-04-06 15:25:00, call4110020230413, buy, 242.6, 41003.55, 3146.350000000004
2023-04-06 15:25:00, put4110020230413, buy, 267.0, 41003.55, 2879.350000000004
2023-04-10 10:15:00, call4090020230413, sell, 253.6, 40936.85, 3132.950000000004
2023-04-10 10:15:00, put4090020230413, sell, 215.65, 40936.85, 3348.600000000004
2023-04-10 10:30:00, put4090020230413, buy, 221.1, 40880.0, 3127.500000000004
2023-04-10 10:35:00, put4090020230413, sell, 207.05, 40898.95, 3334.5500000000043
2023-04-10 11:00:00, put4090020230413, buy, 220.0, 40883.7, 3114.5500000000043
2023-04-10 11:05:00, put4090020230413, sell, 217.2, 40894.2, 3331.750000000004
2023-04-10 11:10:00, put4090020230413, buy, 224.6, 40866.05, 3107.150000000004
2023-04-10 11:15:00, put4090020230413, sell, 224.75, 40896.55, 3331.900000000004
2023-04-10 11:25:00, put4090020230413, buy, 223.05, 40862.75, 3108.850000000004
2023-04-10 11:45:00, put4090020230413, sell, 205.15, 40893.95, 3314.000000000004
2023-04-10 14:20:00, put4090020230413, buy, 293.45, 40841.75, 3020.5500000000043
2023-04-10 15:25:00, call4090020230413, buy, 199.65, 40833.35, 2820.900000000004
2023-04-11 10:15:00, call4120020230413, sell, 239.75, 41248.85, 3060.650000000004
2023-04-11 10:15:00, put4120020230413, sell, 151.2, 41248.85, 3211.850000000004
2023-04-11 10:25:00, call4120020230413, buy, 267.05, 41290.85, 2944.800000000004
2023-04-11 10:35:00, call4120020230413, sell, 244.0, 41263.95, 3188.800000000004
2023-04-11 10:40:00, call4120020230413, buy, 237.85, 41294.55, 2950.950000000004
2023-04-11 10:50:00, call4120020230413, sell, 218.25, 41249.75, 3169.200000000004
2023-04-11 11:10:00, call4120020230413, buy, 276.25, 41339.05, 2892.950000000004
2023-04-11 13:10:00, call4120020230413, sell, 214.35, 41254.15, 3107.300000000004
2023-04-11 13:30:00, call4120020230413, buy, 233.75, 41289.5, 2873.550000000004
2023-04-11 15:25:00, put4120020230413, buy, 102.4, 41352.3, 2771.1500000000037
2023-04-12 10:15:00, call4140020230413, sell, 153.3, 41413.9, 2924.450000000004
2023-04-12 10:15:00, put4140020230413, sell, 143.0, 41413.9, 3067.450000000004
2023-04-12 11:40:00, call4140020230413, buy, 180.4, 41483.0, 2887.050000000004
2023-04-12 11:55:00, call4140020230413, sell, 181.75, 41478.15, 3068.800000000004
2023-04-12 12:00:00, call4140020230413, buy, 175.3, 41498.2, 2893.5000000000036
2023-04-12 12:05:00, call4140020230413, sell, 171.4, 41476.55, 3064.9000000000037
2023-04-12 12:35:00, call4140020230413, buy, 160.0, 41481.25, 2904.9000000000037
2023-04-12 12:40:00, call4140020230413, sell, 160.25, 41439.85, 3065.1500000000037
2023-04-12 13:25:00, call4140020230413, buy, 182.6, 41486.3, 2882.550000000004
2023-04-12 15:00:00, call4140020230413, sell, 202.05, 41477.45, 3084.600000000004
2023-04-12 15:05:00, call4140020230413, buy, 199.45, 41517.25, 2885.150000000004
2023-04-12 15:25:00, put4140020230413, buy, 70.0, 41597.5, 2815.150000000004
2023-04-13 10:15:00, call4160020230420, sell, 340.5, 41685.75, 3155.650000000004
2023-04-13 10:15:00, put4160020230420, sell, 235.4, 41685.75, 3391.0500000000043
2023-04-13 13:50:00, call4160020230420, buy, 369.0, 41798.25, 3022.0500000000043
2023-04-13 13:55:00, call4160020230420, sell, 393.95, 41745.05, 3416.000000000004
2023-04-13 14:00:00, call4160020230420, buy, 397.95, 41818.9, 3018.0500000000043
2023-04-13 15:25:00, put4160020230420, buy, 93.25, 42181.6, 2924.8000000000043
2023-04-17 10:15:00, call4180020230420, sell, 341.85, 41890.05, 3266.650000000004
2023-04-17 10:15:00, put4180020230420, sell, 214.1, 41890.05, 3480.750000000004
2023-04-17 15:25:00, call4180020230420, buy, 560.6, 42262.0, 2920.150000000004
2023-04-17 15:25:00, put4180020230420, buy, 82.75, 42262.0, 2837.400000000004
2023-04-18 10:15:00, call4230020230420, sell, 226.0, 42358.95, 3063.400000000004
2023-04-18 10:15:00, put4230020230420, sell, 181.35, 42358.95, 3244.750000000004
2023-04-18 11:25:00, call4230020230420, buy, 280.5, 42467.3, 2964.250000000004
2023-04-18 11:30:00, call4230020230420, sell, 281.0, 42445.4, 3245.250000000004
2023-04-18 12:50:00, call4230020230420, buy, 267.3, 42453.95, 2977.950000000004
2023-04-18 12:55:00, call4230020230420, sell, 269.35, 42439.7, 3247.300000000004
2023-04-18 13:05:00, call4230020230420, buy, 290.85, 42471.5, 2956.450000000004
2023-04-18 13:30:00, call4230020230420, sell, 245.9, 42433.15, 3202.350000000004
2023-04-18 13:45:00, put4230020230420, buy, 262.5, 42253.1, 2939.850000000004
2023-04-18 14:35:00, put4230020230420, sell, 189.8, 42284.25, 3129.650000000004
2023-04-18 14:40:00, put4230020230420, buy, 224.1, 42267.0, 2905.5500000000043
2023-04-18 14:55:00, put4230020230420, sell, 147.1, 42317.35, 3052.650000000004
2023-04-18 15:15:00, put4230020230420, buy, 192.55, 42262.55, 2860.100000000004
2023-04-18 15:25:00, call4230020230420, buy, 185.3, 42243.15, 2674.800000000004
2023-04-19 10:15:00, call4210020230420, sell, 222.3, 42166.4, 2897.100000000004
2023-04-19 10:15:00, put4210020230420, sell, 121.85, 42166.4, 3018.950000000004
2023-04-19 11:25:00, put4210020230420, buy, 149.0, 42108.1, 2869.950000000004
2023-04-19 11:45:00, put4210020230420, sell, 140.5, 42146.55, 3010.450000000004
2023-04-19 11:50:00, put4210020230420, buy, 138.45, 42130.6, 2872.000000000004
2023-04-19 11:55:00, put4210020230420, sell, 137.75, 42147.05, 3009.750000000004
2023-04-19 12:00:00, put4210020230420, buy, 141.2, 42123.55, 2868.5500000000043
2023-04-19 12:25:00, put4210020230420, sell, 132.45, 42145.9, 3001.000000000004
2023-04-19 13:25:00, put4210020230420, buy, 119.1, 42135.05, 2881.900000000004
2023-04-19 13:30:00, put4210020230420, sell, 119.45, 42196.5, 3001.350000000004
2023-04-19 13:45:00, put4210020230420, buy, 177.4, 42132.65, 2823.950000000004
2023-04-19 14:35:00, put4210020230420, sell, 126.6, 42161.6, 2950.550000000004
2023-04-19 14:45:00, put4210020230420, buy, 141.15, 42132.1, 2809.4000000000037
2023-04-19 14:55:00, put4210020230420, sell, 127.5, 42144.9, 2936.9000000000037
2023-04-19 15:00:00, put4210020230420, buy, 138.9, 42116.15, 2798.0000000000036
2023-04-19 15:15:00, put4210020230420, sell, 105.55, 42163.55, 2903.550000000004
2023-04-19 15:25:00, call4210020230420, buy, 165.0, 42158.8, 2738.550000000004
2023-04-19 15:25:00, put4210020230420, buy, 113.4, 42158.8, 2625.1500000000037
2023-04-20 10:15:00, call4220020230427, sell, 363.65, 42252.7, 2988.800000000004
2023-04-20 10:15:00, put4220020230427, sell, 257.1, 42252.7, 3245.9000000000037
2023-04-20 15:25:00, call4220020230427, buy, 319.95, 42267.05, 2925.950000000004
2023-04-20 15:25:00, put4220020230427, buy, 246.9, 42267.05, 2679.050000000004
2023-04-21 10:15:00, call4220020230427, sell, 287.65, 42204.15, 2966.700000000004
2023-04-21 10:15:00, put4220020230427, sell, 253.75, 42204.15, 3220.450000000004
2023-04-21 11:40:00, put4220020230427, buy, 257.45, 42166.7, 2963.000000000004
2023-04-21 11:45:00, put4220020230427, sell, 255.5, 42193.4, 3218.500000000004
2023-04-21 11:55:00, put4220020230427, buy, 268.0, 42185.15, 2950.500000000004
2023-04-21 15:25:00, call4220020230427, buy, 213.2, 42052.05, 2737.3000000000043
2023-04-24 10:15:00, call4230020230427, sell, 241.7, 42333.1, 2979.000000000004
2023-04-24 10:15:00, put4230020230427, sell, 201.85, 42333.1, 3180.850000000004
2023-04-24 12:55:00, call4230020230427, buy, 346.3, 42487.7, 2834.550000000004
2023-04-24 15:25:00, put4230020230427, buy, 88.85, 42646.65, 2745.700000000004
2023-04-25 10:15:00, call4270020230427, sell, 232.75, 42789.55, 2978.450000000004
2023-04-25 10:15:00, put4270020230427, sell, 144.0, 42789.55, 3122.450000000004
2023-04-25 10:20:00, call4270020230427, buy, 241.0, 42813.25, 2881.450000000004
2023-04-25 10:35:00, call4270020230427, sell, 224.6, 42761.2, 3106.050000000004
2023-04-25 10:45:00, call4270020230427, buy, 234.5, 42801.9, 2871.550000000004
2023-04-25 11:05:00, call4270020230427, sell, 228.75, 42790.2, 3100.300000000004
2023-04-25 11:10:00, call4270020230427, buy, 242.85, 42810.35, 2857.450000000004
2023-04-25 11:50:00, call4270020230427, sell, 237.55, 42781.15, 3095.000000000004
2023-04-25 11:55:00, call4270020230427, buy, 238.7, 42812.1, 2856.3000000000043
2023-04-25 12:10:00, call4270020230427, sell, 228.95, 42782.0, 3085.250000000004
2023-04-25 13:50:00, call4270020230427, buy, 225.0, 42809.9, 2860.250000000004
2023-04-25 13:55:00, call4270020230427, sell, 177.95, 42797.55, 3038.200000000004
2023-04-25 14:20:00, call4270020230427, buy, 227.75, 42803.05, 2810.450000000004
2023-04-25 14:25:00, call4270020230427, sell, 220.9, 42767.05, 3031.350000000004
2023-04-25 14:40:00, call4270020230427, buy, 235.0, 42803.65, 2796.350000000004
2023-04-25 14:50:00, call4270020230427, sell, 209.7, 42787.65, 3006.050000000004
2023-04-25 15:25:00, call4270020230427, buy, 147.95, 42620.8, 2858.100000000004
2023-04-25 15:25:00, put4270020230427, buy, 178.95, 42620.8, 2679.150000000004
2023-04-26 10:15:00, call4240020230427, sell, 241.15, 42496.45, 2920.3000000000043
2023-04-26 10:15:00, put4240020230427, sell, 87.0, 42496.45, 3007.3000000000043
2023-04-26 11:20:00, call4240020230427, buy, 315.0, 42642.55, 2692.3000000000043
2023-04-26 15:25:00, put4240020230427, buy, 22.7, 42822.25, 2669.6000000000045
2023-04-27 10:15:00, call4280020230504, sell, 326.0, 42877.25, 2995.6000000000045
2023-04-27 10:15:00, put4280020230504, sell, 286.5, 42877.25, 3282.1000000000045
2023-04-27 13:35:00, call4280020230504, buy, 382.5, 42949.85, 2899.6000000000045
2023-04-27 13:45:00, call4280020230504, sell, 372.3, 42938.05, 3271.9000000000046
2023-04-27 13:50:00, call4280020230504, buy, 374.6, 42952.85, 2897.3000000000047
2023-04-27 13:55:00, call4280020230504, sell, 376.3, 42924.35, 3273.600000000005
2023-04-27 14:00:00, call4280020230504, buy, 381.4, 42953.5, 2892.200000000005
2023-04-27 14:15:00, call4280020230504, sell, 364.2, 42933.75, 3256.4000000000046
2023-04-27 14:55:00, call4280020230504, buy, 353.2, 42942.2, 2903.200000000005
2023-04-27 15:00:00, call4280020230504, sell, 351.5, 42934.25, 3254.700000000005
2023-04-27 15:05:00, call4280020230504, buy, 359.05, 42952.9, 2895.6500000000046
2023-04-27 15:25:00, put4280020230504, buy, 205.1, 43025.1, 2690.5500000000047
2023-04-27 10:15:00, call4280020230504, sell, 326.0, 42877.25, 3016.5500000000047
2023-04-27 10:15:00, put4280020230504, sell, 286.5, 42877.25, 3303.0500000000047
2023-04-27 13:35:00, call4280020230504, buy, 382.5, 42949.85, 2920.5500000000047
2023-04-27 13:45:00, call4280020230504, sell, 372.3, 42938.05, 3292.850000000005
2023-04-27 13:50:00, call4280020230504, buy, 374.6, 42952.85, 2918.250000000005
2023-04-27 13:55:00, call4280020230504, sell, 376.3, 42924.35, 3294.550000000005
2023-04-27 14:00:00, call4280020230504, buy, 381.4, 42953.5, 2913.150000000005
2023-04-27 14:15:00, call4280020230504, sell, 364.2, 42933.75, 3277.350000000005
2023-04-27 14:55:00, call4280020230504, buy, 353.2, 42942.2, 2924.150000000005
2023-04-27 15:00:00, call4280020230504, sell, 351.5, 42934.25, 3275.650000000005
2023-04-27 15:05:00, call4280020230504, buy, 359.05, 42952.9, 2916.600000000005
2023-04-27 15:25:00, put4280020230504, buy, 205.1, 43025.1, 2711.500000000005
2023-04-28 10:15:00, call4280020230504, sell, 305.45, 42861.15, 3016.950000000005
2023-04-28 10:15:00, put4280020230504, sell, 248.55, 42861.15, 3265.500000000005
2023-04-28 10:20:00, put4280020230504, buy, 242.6, 42831.5, 3022.900000000005
2023-04-28 10:25:00, put4280020230504, sell, 228.85, 42847.3, 3251.750000000005
2023-04-28 10:40:00, put4280020230504, buy, 240.45, 42830.45, 3011.300000000005
2023-04-28 10:55:00, put4280020230504, sell, 204.35, 42873.0, 3215.650000000005
2023-04-28 15:10:00, call4280020230504, buy, 525.8, 43199.7, 2689.850000000005
2023-04-28 15:25:00, put4280020230504, buy, 86.0, 43279.55, 2603.850000000005
2023-05-02 10:15:00, call4340020230504, sell, 192.6, 43411.0, 2796.450000000005
2023-05-02 10:15:00, put4340020230504, sell, 193.95, 43411.0, 2990.4000000000046
2023-05-02 11:55:00, call4340020230504, buy, 210.95, 43475.3, 2779.450000000005
2023-05-02 12:00:00, call4340020230504, sell, 206.25, 43448.05, 2985.700000000005
2023-05-02 12:25:00, call4340020230504, buy, 205.2, 43479.5, 2780.500000000005
2023-05-02 12:30:00, call4340020230504, sell, 209.3, 43457.55, 2989.800000000005
2023-05-02 15:20:00, put4340020230504, buy, 207.75, 43302.05, 2782.050000000005
2023-05-02 15:25:00, call4340020230504, buy, 159.35, 43315.15, 2622.7000000000053
2023-05-03 10:15:00, call4310020230504, sell, 221.2, 43167.6, 2843.900000000005
2023-05-03 10:15:00, put4310020230504, sell, 120.65, 43167.6, 2964.550000000005
2023-05-03 10:50:00, call4310020230504, buy, 269.95, 43274.15, 2694.6000000000054
2023-05-03 11:10:00, call4310020230504, sell, 235.2, 43237.25, 2929.800000000005
2023-05-03 13:30:00, call4310020230504, buy, 250.0, 43248.25, 2679.800000000005
2023-05-03 13:40:00, call4310020230504, sell, 231.9, 43240.15, 2911.7000000000053
2023-05-03 14:15:00, call4310020230504, buy, 231.9, 43255.1, 2679.800000000005
2023-05-03 14:20:00, call4310020230504, sell, 239.35, 43238.95, 2919.150000000005
2023-05-03 14:25:00, call4310020230504, buy, 248.85, 43250.65, 2670.300000000005
2023-05-03 15:25:00, put4310020230504, buy, 66.8, 43330.85, 2603.500000000005
2023-05-04 10:15:00, call4330020230511, sell, 304.2, 43322.75, 2907.700000000005
2023-05-04 10:15:00, put4330020230511, sell, 289.65, 43322.75, 3197.350000000005
2023-05-04 11:10:00, call4330020230511, buy, 334.85, 43390.85, 2862.500000000005
2023-05-04 12:20:00, call4330020230511, sell, 344.35, 43352.55, 3206.850000000005
2023-05-04 12:25:00, call4330020230511, buy, 345.45, 43418.05, 2861.400000000005
2023-05-04 15:25:00, put4330020230511, buy, 135.4, 43716.55, 2726.000000000005
2023-05-05 10:15:00, call4350020230511, sell, 297.95, 43534.85, 3023.950000000005
2023-05-05 10:15:00, put4350020230511, sell, 226.3, 43534.85, 3250.250000000005
2023-05-05 10:25:00, call4350020230511, buy, 307.1, 43557.05, 2943.150000000005
2023-05-05 10:35:00, call4350020230511, sell, 283.3, 43539.0, 3226.4500000000053
2023-05-05 13:50:00, put4350020230511, buy, 621.85, 43065.85, 2604.6000000000054
2023-05-05 15:25:00, call4350020230511, buy, 59.1, 42625.1, 2545.5000000000055
2023-05-08 10:15:00, call4320020230511, sell, 245.15, 43206.75, 2790.6500000000055
2023-05-08 10:15:00, put4320020230511, sell, 260.5, 43206.75, 3051.1500000000055
2023-05-08 13:40:00, call4320020230511, buy, 315.4, 43319.7, 2735.7500000000055
2023-05-08 13:45:00, call4320020230511, sell, 314.1, 43302.15, 3049.8500000000054
2023-05-08 14:00:00, call4320020230511, buy, 377.25, 43345.9, 2672.6000000000054
2023-05-08 14:20:00, call4320020230511, sell, 315.25, 43300.55, 2987.8500000000054
2023-05-08 14:45:00, call4320020230511, buy, 332.45, 43336.1, 2655.4000000000055
2023-05-08 15:10:00, call4320020230511, sell, 268.75, 43296.95, 2924.1500000000055
2023-05-08 15:25:00, call4320020230511, buy, 325.1, 43317.85, 2599.0500000000056
2023-05-08 15:25:00, put4320020230511, buy, 145.75, 43317.85, 2453.3000000000056
2023-05-09 10:15:00, call4330020230511, sell, 290.75, 43381.35, 2744.0500000000056
2023-05-09 10:15:00, put4330020230511, sell, 138.6, 43381.35, 2882.6500000000055
2023-05-09 12:05:00, call4330020230511, buy, 319.7, 43508.2, 2562.9500000000057
2023-05-09 12:20:00, call4330020230511, sell, 306.25, 43472.15, 2869.2000000000057
2023-05-09 12:35:00, call4330020230511, buy, 296.4, 43492.0, 2572.8000000000056
2023-05-09 12:40:00, call4330020230511, sell, 313.95, 43464.5, 2886.7500000000055
2023-05-09 12:45:00, call4330020230511, buy, 314.45, 43502.85, 2572.3000000000056
2023-05-09 13:00:00, call4330020230511, sell, 294.25, 43462.85, 2866.5500000000056
2023-05-09 14:05:00, put4330020230511, buy, 223.95, 43218.75, 2642.600000000006
2023-05-09 14:15:00, put4330020230511, sell, 218.0, 43286.3, 2860.600000000006
2023-05-09 14:20:00, put4330020230511, buy, 215.9, 43258.4, 2644.7000000000057
2023-05-09 14:35:00, put4330020230511, sell, 159.4, 43308.5, 2804.100000000006
2023-05-09 14:50:00, put4330020230511, buy, 208.35, 43276.7, 2595.750000000006
2023-05-09 15:05:00, put4330020230511, sell, 194.05, 43281.3, 2789.800000000006
2023-05-09 15:10:00, put4330020230511, buy, 224.9, 43230.15, 2564.900000000006
2023-05-09 15:25:00, call4330020230511, buy, 147.45, 43146.6, 2417.450000000006
2023-05-10 10:15:00, call4290020230511, sell, 227.65, 42919.55, 2645.1000000000063
2023-05-10 10:15:00, put4290020230511, sell, 181.3, 42919.55, 2826.4000000000065
2023-05-10 15:25:00, call4290020230511, buy, 472.35, 43364.95, 2354.0500000000065
2023-05-10 15:25:00, put4290020230511, buy, 34.55, 43364.95, 2319.5000000000064
2023-05-11 10:15:00, call4350020230518, sell, 349.15, 43558.95, 2668.6500000000065
2023-05-11 10:15:00, put4350020230518, sell, 306.85, 43558.95, 2975.5000000000064
2023-05-11 10:55:00, call4350020230518, buy, 363.35, 43632.6, 2612.1500000000065
2023-05-11 11:05:00, call4350020230518, sell, 337.5, 43589.1, 2949.6500000000065
2023-05-11 14:25:00, call4350020230518, buy, 377.25, 43636.15, 2572.4000000000065
2023-05-11 14:35:00, call4350020230518, sell, 335.0, 43588.9, 2907.4000000000065
2023-05-11 15:25:00, call4350020230518, buy, 297.45, 43486.2, 2609.9500000000066
2023-05-11 15:25:00, put4350020230518, buy, 311.95, 43486.2, 2298.000000000007
2023-05-12 10:15:00, call4340020230518, sell, 311.05, 43457.55, 2609.050000000007
2023-05-12 10:15:00, put4340020230518, sell, 286.5, 43457.55, 2895.550000000007
2023-05-12 10:45:00, call4340020230518, buy, 363.85, 43555.95, 2531.700000000007
2023-05-12 11:30:00, call4340020230518, sell, 328.0, 43497.25, 2859.700000000007
2023-05-12 12:00:00, call4340020230518, buy, 358.8, 43555.65, 2500.900000000007
2023-05-12 15:25:00, put4340020230518, buy, 166.8, 43781.65, 2334.1000000000067
2023-05-15 10:15:00, call4390020230518, sell, 271.0, 43961.4, 2605.1000000000067
2023-05-15 10:15:00, put4390020230518, sell, 254.35, 43961.4, 2859.4500000000066
2023-05-15 10:45:00, call4390020230518, buy, 267.9, 43978.65, 2591.5500000000065
2023-05-15 10:50:00, call4390020230518, sell, 268.1, 43965.85, 2859.6500000000065
2023-05-15 10:55:00, call4390020230518, buy, 253.55, 43970.45, 2606.1000000000063
2023-05-15 11:00:00, call4390020230518, sell, 264.35, 43928.65, 2870.450000000006
2023-05-15 11:05:00, call4390020230518, buy, 279.0, 43986.45, 2591.450000000006
2023-05-15 15:25:00, put4390020230518, buy, 208.0, 44103.5, 2383.450000000006
2023-05-16 10:15:00, call4400020230518, sell, 282.85, 44077.45, 2666.300000000006
2023-05-16 10:15:00, put4400020230518, sell, 175.0, 44077.45, 2841.300000000006
2023-05-16 15:25:00, call4400020230518, buy, 145.45, 43905.6, 2695.8500000000063
2023-05-16 15:25:00, put4400020230518, buy, 260.55, 43905.6, 2435.300000000006
2023-05-17 10:15:00, call4380020230518, sell, 230.6, 43877.45, 2665.900000000006
2023-05-17 10:15:00, put4380020230518, sell, 136.4, 43877.45, 2802.300000000006
2023-05-17 10:45:00, put4380020230518, buy, 176.55, 43803.5, 2625.750000000006
2023-05-17 11:05:00, put4380020230518, sell, 169.8, 43812.15, 2795.550000000006
2023-05-17 11:40:00, put4380020230518, buy, 184.45, 43775.5, 2611.1000000000063
2023-05-17 15:25:00, call4380020230518, buy, 102.45, 43733.15, 2508.6500000000065
2023-05-18 10:15:00, call4380020230525, sell, 395.55, 43891.15, 2904.2000000000066
2023-05-18 10:15:00, put4380020230525, sell, 268.0, 43891.15, 3172.2000000000066
2023-05-18 14:15:00, put4380020230525, buy, 303.2, 43818.5, 2869.000000000007
2023-05-18 14:30:00, put4380020230525, sell, 277.75, 43852.25, 3146.750000000007
2023-05-18 14:45:00, put4380020230525, buy, 289.05, 43814.1, 2857.7000000000066
2023-05-18 14:50:00, put4380020230525, sell, 302.65, 43862.95, 3160.3500000000067
2023-05-18 14:55:00, put4380020230525, buy, 285.4, 43830.75, 2874.9500000000066
2023-05-18 15:00:00, put4380020230525, sell, 298.0, 43864.15, 3172.9500000000066
2023-05-18 15:05:00, put4380020230525, buy, 319.95, 43844.55, 2853.000000000007
2023-05-18 15:25:00, call4380020230525, buy, 308.6, 43760.4, 2544.400000000007
2023-05-19 10:15:00, call4350020230525, sell, 371.05, 43581.15, 2915.450000000007
2023-05-19 10:15:00, put4350020230525, sell, 253.4, 43581.15, 3168.850000000007
2023-05-19 15:15:00, call4350020230525, buy, 584.45, 43969.15, 2584.400000000007
2023-05-19 15:25:00, put4350020230525, buy, 99.15, 44003.0, 2485.250000000007
2023-05-22 10:15:00, call4380020230525, sell, 295.25, 43851.45, 2780.500000000007
2023-05-22 10:15:00, put4380020230525, sell, 212.6, 43851.45, 2993.1000000000067
2023-05-22 13:35:00, put4380020230525, buy, 282.55, 43788.95, 2710.5500000000065
2023-05-22 14:00:00, put4380020230525, sell, 225.2, 43791.1, 2935.7500000000064
2023-05-22 14:35:00, put4380020230525, buy, 226.6, 43787.9, 2709.1500000000065
2023-05-22 14:55:00, put4380020230525, sell, 188.45, 43857.3, 2897.6000000000063
2023-05-22 15:25:00, call4380020230525, buy, 278.8, 43900.9, 2618.800000000006
2023-05-22 15:25:00, put4380020230525, buy, 182.8, 43900.9, 2436.000000000006
2023-05-23 10:15:00, call4400020230525, sell, 209.55, 44015.75, 2645.550000000006
2023-05-23 10:15:00, put4400020230525, sell, 196.0, 44015.75, 2841.550000000006
2023-05-23 10:55:00, call4400020230525, buy, 223.0, 44060.3, 2618.550000000006
2023-05-23 11:00:00, call4400020230525, sell, 219.2, 44056.95, 2837.750000000006
2023-05-23 11:15:00, call4400020230525, buy, 214.05, 44062.4, 2623.7000000000057
2023-05-23 11:20:00, call4400020230525, sell, 208.0, 44051.1, 2831.7000000000057
2023-05-23 13:05:00, call4400020230525, buy, 200.4, 44070.7, 2631.3000000000056
2023-05-23 13:10:00, call4400020230525, sell, 199.05, 44019.2, 2830.350000000006
2023-05-23 13:40:00, call4400020230525, buy, 210.35, 44057.85, 2620.000000000006
2023-05-23 13:50:00, call4400020230525, sell, 220.2, 44046.0, 2840.2000000000057
2023-05-23 13:55:00, call4400020230525, buy, 215.75, 44058.75, 2624.4500000000057
2023-05-23 14:05:00, call4400020230525, sell, 216.05, 44035.85, 2840.500000000006
2023-05-23 14:10:00, call4400020230525, buy, 215.65, 44064.7, 2624.850000000006
2023-05-23 14:15:00, call4400020230525, sell, 210.1, 44053.0, 2834.9500000000057
2023-05-23 14:25:00, call4400020230525, buy, 214.75, 44081.3, 2620.2000000000057
2023-05-23 14:30:00, call4400020230525, sell, 218.6, 44053.9, 2838.8000000000056
2023-05-23 14:35:00, call4400020230525, buy, 216.65, 44080.05, 2622.1500000000055
2023-05-23 14:45:00, call4400020230525, sell, 197.8, 44057.55, 2819.9500000000057
2023-05-23 15:25:00, call4400020230525, buy, 156.75, 43931.55, 2663.2000000000057
2023-05-23 15:25:00, put4400020230525, buy, 204.9, 43931.55, 2458.3000000000056
2023-05-24 10:15:00, call4380020230525, sell, 230.3, 43896.0, 2688.600000000006
2023-05-24 10:15:00, put4380020230525, sell, 109.75, 43896.0, 2798.350000000006
2023-05-24 10:50:00, call4380020230525, buy, 263.65, 43945.55, 2534.7000000000057
2023-05-24 11:15:00, call4380020230525, sell, 252.4, 43932.55, 2787.100000000006
2023-05-24 11:25:00, call4380020230525, buy, 271.85, 43978.0, 2515.250000000006
2023-05-24 11:50:00, call4380020230525, sell, 226.7, 43918.35, 2741.9500000000057
2023-05-24 15:00:00, put4380020230525, buy, 191.65, 43688.45, 2550.3000000000056
2023-05-24 15:25:00, call4380020230525, buy, 98.75, 43686.65, 2451.5500000000056
2023-05-25 10:15:00, call4350020230601, sell, 399.7, 43517.15, 2851.2500000000055
2023-05-25 10:15:00, put4350020230601, sell, 300.9, 43517.15, 3152.1500000000055
2023-05-25 10:30:00, put4350020230601, buy, 323.55, 43509.5, 2828.6000000000054
2023-05-25 10:35:00, put4350020230601, sell, 309.25, 43514.4, 3137.8500000000054
2023-05-25 10:50:00, put4350020230601, buy, 312.05, 43505.75, 2825.800000000005
2023-05-25 10:55:00, put4350020230601, sell, 322.55, 43533.4, 3148.3500000000054
2023-05-25 11:00:00, put4350020230601, buy, 317.8, 43492.95, 2830.550000000005
2023-05-25 11:05:00, put4350020230601, sell, 318.05, 43525.1, 3148.6000000000054
2023-05-25 11:25:00, put4350020230601, buy, 335.25, 43500.1, 2813.3500000000054
2023-05-25 12:00:00, put4350020230601, sell, 324.25, 43513.95, 3137.6000000000054
2023-05-25 12:10:00, put4350020230601, buy, 317.7, 43501.2, 2819.9000000000055
2023-05-25 12:15:00, put4350020230601, sell, 317.95, 43543.3, 3137.8500000000054
2023-05-25 13:05:00, put4350020230601, buy, 362.05, 43494.35, 2775.800000000005
2023-05-25 14:20:00, put4350020230601, sell, 327.0, 43524.5, 3102.800000000005
2023-05-25 14:25:00, put4350020230601, buy, 291.3, 43509.8, 2811.500000000005
2023-05-25 14:30:00, put4350020230601, sell, 305.25, 43571.05, 3116.750000000005
2023-05-25 15:25:00, call4350020230601, buy, 408.75, 43686.95, 2708.000000000005
2023-05-25 15:25:00, put4350020230601, buy, 223.6, 43686.95, 2484.400000000005
2023-05-25 10:15:00, call4350020230601, sell, 399.7, 43517.15, 2884.100000000005
2023-05-25 10:15:00, put4350020230601, sell, 300.9, 43517.15, 3185.000000000005
2023-05-25 10:30:00, put4350020230601, buy, 323.55, 43509.5, 2861.450000000005
2023-05-25 10:35:00, put4350020230601, sell, 309.25, 43514.4, 3170.700000000005
2023-05-25 10:50:00, put4350020230601, buy, 312.05, 43505.75, 2858.6500000000046
2023-05-25 10:55:00, put4350020230601, sell, 322.55, 43533.4, 3181.200000000005
2023-05-25 11:00:00, put4350020230601, buy, 317.8, 43492.95, 2863.4000000000046
2023-05-25 11:05:00, put4350020230601, sell, 318.05, 43525.1, 3181.450000000005
2023-05-25 11:25:00, put4350020230601, buy, 335.25, 43500.1, 2846.200000000005
2023-05-25 12:00:00, put4350020230601, sell, 324.25, 43513.95, 3170.450000000005
2023-05-25 12:10:00, put4350020230601, buy, 317.7, 43501.2, 2852.750000000005
2023-05-25 12:15:00, put4350020230601, sell, 317.95, 43543.3, 3170.700000000005
2023-05-25 13:05:00, put4350020230601, buy, 362.05, 43494.35, 2808.6500000000046
2023-05-25 14:20:00, put4350020230601, sell, 327.0, 43524.5, 3135.6500000000046
2023-05-25 14:25:00, put4350020230601, buy, 291.3, 43509.8, 2844.3500000000045
2023-05-25 14:30:00, put4350020230601, sell, 305.25, 43571.05, 3149.6000000000045
2023-05-25 15:25:00, call4350020230601, buy, 408.75, 43686.95, 2740.8500000000045
2023-05-25 15:25:00, put4350020230601, buy, 223.6, 43686.95, 2517.2500000000045
2023-05-26 10:15:00, call4360020230601, sell, 302.25, 43697.5, 2819.5000000000045
2023-05-26 10:15:00, put4360020230601, sell, 260.4, 43697.5, 3079.9000000000046
2023-05-26 12:10:00, call4360020230601, buy, 390.85, 43777.9, 2689.0500000000047
2023-05-26 15:25:00, put4360020230601, buy, 131.85, 43991.15, 2557.200000000005
2023-05-29 10:15:00, call4430020230601, sell, 267.15, 44366.1, 2824.350000000005
2023-05-29 10:15:00, put4430020230601, sell, 215.35, 44366.1, 3039.700000000005
2023-05-29 11:25:00, call4430020230601, buy, 323.5, 44464.1, 2716.200000000005
2023-05-29 11:30:00, call4430020230601, sell, 315.55, 44455.35, 3031.750000000005
2023-05-29 15:25:00, call4430020230601, buy, 225.35, 44288.7, 2806.400000000005
2023-05-29 15:25:00, put4430020230601, buy, 212.4, 44288.7, 2594.000000000005
2023-05-30 10:15:00, call4430020230601, sell, 230.55, 44382.45, 2824.550000000005
2023-05-30 10:15:00, put4430020230601, sell, 163.5, 44382.45, 2988.050000000005
2023-05-30 14:50:00, call4430020230601, buy, 226.2, 44430.85, 2761.8500000000054
2023-05-30 14:55:00, call4430020230601, sell, 231.95, 44408.7, 2993.800000000005
2023-05-30 15:00:00, call4430020230601, buy, 230.5, 44417.7, 2763.300000000005
2023-05-30 15:10:00, call4430020230601, sell, 243.7, 44407.9, 3007.000000000005
2023-05-30 15:15:00, call4430020230601, buy, 241.15, 44470.3, 2765.850000000005
2023-05-30 15:25:00, put4430020230601, buy, 113.05, 44453.4, 2652.8000000000047
2023-05-31 10:15:00, call4410020230601, sell, 190.05, 44136.7, 2842.850000000005
2023-05-31 10:15:00, put4410020230601, sell, 131.75, 44136.7, 2974.600000000005
2023-05-31 11:40:00, put4410020230601, buy, 171.7, 44049.35, 2802.900000000005
2023-05-31 15:15:00, put4410020230601, sell, 109.75, 44095.35, 2912.650000000005
2023-05-31 15:25:00, call4410020230601, buy, 173.5, 44206.7, 2739.150000000005
2023-05-31 15:25:00, put4410020230601, buy, 95.85, 44206.7, 2643.300000000005
2023-06-01 10:15:00, call4400020230608, sell, 387.55, 44091.05, 3030.8500000000054
2023-06-01 10:15:00, put4400020230608, sell, 251.6, 44091.05, 3282.4500000000053
2023-06-01 14:30:00, put4400020230608, buy, 276.95, 43933.35, 3005.5000000000055
2023-06-01 14:35:00, put4400020230608, sell, 304.95, 43993.0, 3310.4500000000053
2023-06-01 14:40:00, put4400020230608, buy, 300.85, 43941.05, 3009.6000000000054
2023-06-01 15:25:00, call4400020230608, buy, 250.85, 43715.2, 2758.7500000000055
2023-06-02 10:15:00, call4380020230608, sell, 347.55, 43851.05, 3106.3000000000056
2023-06-02 10:15:00, put4380020230608, sell, 242.2, 43851.05, 3348.5000000000055
2023-06-02 10:25:00, put4380020230608, buy, 253.35, 43843.2, 3095.1500000000055
2023-06-02 10:35:00, put4380020230608, sell, 224.25, 43850.3, 3319.4000000000055
2023-06-02 13:15:00, call4380020230608, buy, 481.35, 44054.35, 2838.0500000000056
2023-06-02 13:30:00, call4380020230608, sell, 500.35, 44028.7, 3338.4000000000055
2023-06-02 13:35:00, call4380020230608, buy, 493.4, 44067.85, 2845.0000000000055
2023-06-02 14:00:00, call4380020230608, sell, 463.3, 44036.7, 3308.3000000000056
2023-06-02 14:05:00, call4380020230608, buy, 464.85, 44047.75, 2843.4500000000057
2023-06-02 14:15:00, call4380020230608, sell, 395.6, 43983.95, 3239.0500000000056
2023-06-02 15:25:00, call4380020230608, buy, 365.7, 43878.85, 2873.350000000006
2023-06-02 15:25:00, put4380020230608, buy, 180.75, 43878.85, 2692.600000000006
2023-06-05 10:15:00, call4420020230608, sell, 248.8, 44203.1, 2941.400000000006
2023-06-05 10:15:00, put4420020230608, sell, 199.4, 44203.1, 3140.800000000006
2023-06-05 11:15:00, call4420020230608, buy, 256.05, 44247.65, 2884.750000000006
2023-06-05 11:25:00, call4420020230608, sell, 260.3, 44241.9, 3145.050000000006
2023-06-05 11:30:00, call4420020230608, buy, 258.8, 44249.3, 2886.250000000006
2023-06-05 11:40:00, call4420020230608, sell, 247.95, 44229.55, 3134.2000000000057
2023-06-05 14:00:00, call4420020230608, buy, 261.25, 44248.05, 2872.9500000000057
2023-06-05 14:05:00, call4420020230608, sell, 241.2, 44243.85, 3114.1500000000055
2023-06-05 15:15:00, put4420020230608, buy, 200.6, 44098.7, 2913.5500000000056
2023-06-05 15:20:00, put4420020230608, sell, 219.05, 44137.15, 3132.600000000006
2023-06-05 15:25:00, call4420020230608, buy, 195.85, 44095.6, 2936.750000000006
2023-06-05 15:25:00, put4420020230608, buy, 209.85, 44095.6, 2726.900000000006
2023-06-06 10:15:00, call4400020230608, sell, 254.0, 44086.7, 2980.900000000006
2023-06-06 10:15:00, put4400020230608, sell, 134.0, 44086.7, 3114.900000000006
2023-06-06 10:35:00, put4400020230608, buy, 142.05, 44062.55, 2972.850000000006
2023-06-06 10:40:00, put4400020230608, sell, 145.2, 44081.75, 3118.0500000000056
2023-06-06 10:55:00, put4400020230608, buy, 155.7, 44047.7, 2962.350000000006
2023-06-06 11:35:00, put4400020230608, sell, 140.6, 44070.2, 3102.9500000000057
2023-06-06 11:45:00, put4400020230608, buy, 141.25, 44062.05, 2961.7000000000057
2023-06-06 11:50:00, put4400020230608, sell, 140.2, 44065.45, 3101.9000000000055
2023-06-06 14:30:00, put4400020230608, buy, 118.65, 44061.5, 2983.2500000000055
2023-06-06 14:35:00, put4400020230608, sell, 125.4, 44079.7, 3108.6500000000055
2023-06-06 14:45:00, put4400020230608, buy, 134.05, 44056.25, 2974.6000000000054
2023-06-06 14:55:00, put4400020230608, sell, 124.2, 44066.9, 3098.800000000005
2023-06-06 15:20:00, call4400020230608, buy, 294.95, 44220.1, 2803.8500000000054
2023-06-06 15:25:00, put4400020230608, buy, 84.2, 44209.15, 2719.6500000000055
2023-06-07 10:15:00, call4420020230608, sell, 184.35, 44264.4, 2904.0000000000055
2023-06-07 10:15:00, put4420020230608, sell, 103.9, 44264.4, 3007.9000000000055
2023-06-07 10:50:00, put4420020230608, buy, 132.5, 44190.8, 2875.4000000000055
2023-06-07 14:35:00, put4420020230608, sell, 100.25, 44233.5, 2975.6500000000055
2023-06-07 14:40:00, put4420020230608, buy, 99.6, 44223.0, 2876.0500000000056
2023-06-07 14:55:00, put4420020230608, sell, 98.6, 44237.95, 2974.6500000000055
2023-06-07 15:25:00, call4420020230608, buy, 170.1, 44268.25, 2804.5500000000056
2023-06-07 15:25:00, put4420020230608, buy, 91.95, 44268.25, 2712.600000000006
2023-06-08 10:15:00, call4430020230615, sell, 363.8, 44387.35, 3076.400000000006
2023-06-08 10:15:00, put4430020230615, sell, 247.6, 44387.35, 3324.000000000006
2023-06-08 10:25:00, call4430020230615, buy, 372.95, 44438.6, 2951.050000000006
2023-06-08 10:30:00, call4430020230615, sell, 367.15, 44415.05, 3318.200000000006
2023-06-08 10:45:00, call4430020230615, buy, 377.45, 44441.0, 2940.7500000000064
2023-06-08 11:00:00, call4430020230615, sell, 373.5, 44434.65, 3314.2500000000064
2023-06-08 11:05:00, call4430020230615, buy, 372.15, 44438.45, 2942.1000000000063
2023-06-08 11:10:00, call4430020230615, sell, 375.85, 44423.9, 3317.950000000006
2023-06-08 11:40:00, call4430020230615, buy, 367.2, 44437.95, 2950.7500000000064
2023-06-08 11:45:00, call4430020230615, sell, 339.5, 44432.95, 3290.2500000000064
2023-06-08 14:15:00, put4430020230615, buy, 286.0, 44202.25, 3004.2500000000064
2023-06-08 14:20:00, put4430020230615, sell, 296.5, 44231.25, 3300.7500000000064
2023-06-08 14:30:00, put4430020230615, buy, 284.45, 44201.2, 3016.3000000000065
2023-06-08 14:35:00, put4430020230615, sell, 282.45, 44212.5, 3298.7500000000064
2023-06-08 14:45:00, put4430020230615, buy, 282.6, 44204.5, 3016.1500000000065
2023-06-08 14:50:00, put4430020230615, sell, 330.0, 44228.5, 3346.1500000000065
2023-06-08 14:55:00, put4430020230615, buy, 345.05, 44105.8, 3001.1000000000063
2023-06-08 15:25:00, call4430020230615, buy, 189.75, 43941.55, 2811.3500000000063
2023-06-09 10:15:00, call4420020230615, sell, 252.7, 44214.6, 3064.050000000006
2023-06-09 10:15:00, put4420020230615, sell, 263.8, 44214.6, 3327.8500000000063
2023-06-09 15:25:00, call4420020230615, buy, 168.45, 44001.1, 3159.4000000000065
2023-06-09 15:25:00, put4420020230615, buy, 334.0, 44001.1, 2825.4000000000065
2023-06-12 10:15:00, call4390020230615, sell, 284.0, 43954.75, 3109.4000000000065
2023-06-12 10:15:00, put4390020230615, sell, 173.05, 43954.75, 3282.4500000000066
2023-06-12 14:25:00, put4390020230615, buy, 198.85, 43909.95, 3083.6000000000067
2023-06-12 14:55:00, put4390020230615, sell, 168.0, 43945.05, 3251.6000000000067
2023-06-12 15:25:00, call4390020230615, buy, 269.7, 43932.85, 2981.900000000007
2023-06-12 15:25:00, put4390020230615, buy, 156.0, 43932.85, 2825.900000000007
2023-06-13 10:15:00, call4400020230615, sell, 245.1, 44065.0, 3071.000000000007
2023-06-13 10:15:00, put4400020230615, sell, 129.8, 44065.0, 3200.800000000007
2023-06-13 15:25:00, call4400020230615, buy, 250.2, 44121.95, 2950.600000000007
2023-06-13 15:25:00, put4400020230615, buy, 102.9, 44121.95, 2847.700000000007
2023-06-14 10:15:00, call4390020230615, sell, 243.1, 43989.75, 3090.800000000007
2023-06-14 10:15:00, put4390020230615, sell, 93.5, 43989.75, 3184.300000000007
2023-06-14 15:25:00, call4390020230615, buy, 230.7, 43977.75, 2953.600000000007
2023-06-14 15:25:00, put4390020230615, buy, 79.05, 43977.75, 2874.550000000007
2023-06-15 10:15:00, call4390020230622, sell, 317.25, 43901.25, 3191.800000000007
2023-06-15 10:15:00, put4390020230622, sell, 253.7, 43901.25, 3445.500000000007
2023-06-15 11:30:00, put4390020230622, buy, 297.5, 43825.05, 3148.000000000007
2023-06-15 15:25:00, call4390020230622, buy, 130.0, 43408.95, 3018.000000000007
2023-06-16 10:15:00, call4360020230622, sell, 346.1, 43696.65, 3364.1000000000067
2023-06-16 10:15:00, put4360020230622, sell, 169.4, 43696.65, 3533.500000000007
2023-06-16 10:20:00, call4360020230622, buy, 338.15, 43741.9, 3195.3500000000067
2023-06-16 10:25:00, call4360020230622, sell, 339.3, 43727.7, 3534.650000000007
2023-06-16 10:30:00, call4360020230622, buy, 358.55, 43730.7, 3176.1000000000067
2023-06-16 11:00:00, call4360020230622, sell, 352.3, 43727.2, 3528.400000000007
2023-06-16 11:05:00, call4360020230622, buy, 340.15, 43756.6, 3188.250000000007
2023-06-16 11:15:00, call4360020230622, sell, 345.5, 43717.2, 3533.750000000007
2023-06-16 11:20:00, call4360020230622, buy, 345.45, 43742.15, 3188.300000000007
2023-06-16 11:30:00, call4360020230622, sell, 342.25, 43700.1, 3530.550000000007
2023-06-16 11:35:00, call4360020230622, buy, 346.0, 43739.2, 3184.550000000007
2023-06-16 13:45:00, call4360020230622, sell, 341.4, 43723.75, 3525.950000000007
2023-06-16 13:50:00, call4360020230622, buy, 337.9, 43744.7, 3188.050000000007
2023-06-16 13:55:00, call4360020230622, sell, 322.9, 43721.5, 3510.950000000007
2023-06-16 14:15:00, call4360020230622, buy, 378.0, 43738.1, 3132.950000000007
2023-06-16 15:25:00, put4360020230622, buy, 105.45, 43861.85, 3027.5000000000073
2023-06-19 10:15:00, call4380020230622, sell, 272.55, 43885.25, 3300.0500000000075
2023-06-19 10:15:00, put4380020230622, sell, 156.05, 43885.25, 3456.1000000000076
2023-06-19 10:25:00, put4380020230622, buy, 204.8, 43784.5, 3251.3000000000075
2023-06-19 15:25:00, call4380020230622, buy, 167.75, 43631.75, 3083.5500000000075
